AAAACGAGGTGTATCATAG -> AAACGAGGTGTATCATAGA
AAAAGCCGGCCATTTGGAG -> AAAGCCGGCCATTTGGAGA
AAACAGCGCTCCACCTATC -> AACAGCGCTCCACCTATCC
AAACATATGAGGAGGGGCC -> AACATATGAGGAGGGGCCC
AAACATCATGGTAACCCGG -> AACATCATGGTAACCCGGG
AAACATGGAACGCACGACT -> AACATGGAACGCACGACTA
AAACCATTAAGCTATCCGA -> AACCATTAAGCTATCCGAC
AAACCATTACACAGCCTCG -> AACCATTACACAGCCTCGT
AAACCATTAGACGACGCTC -> AACCATTAGACGACGCTCA
AAACCATTATCGGTGCTGT -> AACCATTATCGGTGCTGTT
AAACCTGTCTCCAAACTCC -> AACCTGTCTCCAAACTCCA
AAACGAGGTGTATCATAGA -> AACGAGGTGTATCATAGAC
AAACTAGTACGACGGACCA -> AACTAGTACGACGGACCAT
AAACTCCATTGTACGTGCA -> AACTCCATTGTACGTGCAC
AAAGACTAGCAACACTTAC -> AAGACTAGCAACACTTACT
AAAGATCAGCCGCGTACCC -> AAGATCAGCCGCGTACCCC
AAAGCATTTGACTTAACGT -> AAGCATTTGACTTAACGTC
AAAGCCGGCCATTTGGAGA -> AAGCCGGCCATTTGGAGAT
AAAGCGATGTGTACTCTTC -> AAGCGATGTGTACTCTTCG
AAAGTACACAAGTATGTCG -> AAGTACACAAGTATGTCGA
AAAGTAGAGACAATGTATG -> AAGTAGAGACAATGTATGA
AAATAACAGCGTGGCCTGC -> AATAACAGCGTGGCCTGCC
AAATAGCAACCCCCCTTCA -> AATAGCAACCCCCCTTCAG
AAATAGTGCGCTCAACGCA -> AATAGTGCGCTCAACGCAA
AAATCCTATCCCAGTGGCA -> AATCCTATCCCAGTGGCAC
AAATTCTTGTTTCCCACTA -> AATTCTTGTTTCCCACTAC
AACAAAGACTAGCAACACT -> ACAAAGACTAGCAACACTT
AACAAATAACAGCGTGGCC -> ACAAATAACAGCGTGGCCT
AACACAATCTTTTCCTTTC -> ACACAATCTTTTCCTTTCC
AACACTTACTGGTTCGCGC -> ACACTTACTGGTTCGCGCT
AACAGCGCTCCACCTATCC -> ACAGCGCTCCACCTATCCT
AACAGCGTGGCCTGCCTCT -> ACAGCGTGGCCTGCCTCTG
AACAGGGAGTCGGTTTACG -> ACAGGGAGTCGGTTTACGA
AACATACGGCTGAGTGGGG -> ACATACGGCTGAGTGGGGG
AACATATGAGGAGGGGCCC -> ACATATGAGGAGGGGCCCA
AACATCATGGTAACCCGGG -> ACATCATGGTAACCCGGGA
AACATGGAACGCACGACTA -> ACATGGAACGCACGACTAG
AACCAATGAGGCAGAGGAC -> ACCAATGAGGCAGAGGACC
AACCACCGTCTCCCTAACT -> ACCACCGTCTCCCTAACTC
AACCATTAAGCTATCCGAC -> ACCATTAAGCTATCCGACA
AACCATTACACAGCCTCGT -> ACCATTACACAGCCTCGTA
AACCATTAGACGACGCTCA -> ACCATTAGACGACGCTCAA
AACCATTATCGGTGCTGTT -> ACCATTATCGGTGCTGTTA
AACCCCCCTTCAGACTAAA -> ACCCCCCTTCAGACTAAAC
AACCCGGGATTAGCTTCTC -> ACCCGGGATTAGCTTCTCC
AACCGAACGTTGGGAGGCG -> ACCGAACGTTGGGAGGCGC
AACCGTCGTACGAGCGCCC -> ACCGTCGTACGAGCGCCCT
AACCTACATGCTATAGGAT -> ACCTACATGCTATAGGATA
AACCTGTCTCCAAACTCCA -> ACCTGTCTCCAAACTCCAT
AACGAAGGCTACGTGGTGC -> ACGAAGGCTACGTGGTGCC
AACGAGGTGTATCATAGAC -> ACGAGGTGTATCATAGACC
AACGCAAACCATTAAGCTA -> ACGCAAACCATTAAGCTAT
AACGCAAACCATTACACAG -> ACGCAAACCATTACACAGC
AACGCAAACCATTAGACGA -> ACGCAAACCATTAGACGAC
AACGCAAACCATTATCGGT -> ACGCAAACCATTATCGGTG
AACGCACGACTAGGTGCCT -> ACGCACGACTAGGTGCCTC
AACGCCGAAGCGCGCAAGG -> ACGCCGAAGCGCGCAAGGA
AACGGTACTGGGTGCAATC -> ACGGTACTGGGTGCAATCC
AACGTCTATTCATAACGGT -> ACGTCTATTCATAACGGTA
AACGTTGACCCTTAACCGT -> ACGTTGACCCTTAACCGTC
AACGTTGGGAGGCGCGTTT -> ACGTTGGGAGGCGCGTTTA
AACTACATTTTACCTCCGG -> ACTACATTTTACCTCCGGG
AACTAGTACGACGGACCAT -> ACTAGTACGACGGACCATA
AACTCACATCAACGTTGAC -> ACTCACATCAACGTTGACC
AACTCCATTGTACGTGCAC -> ACTCCATTGTACGTGCACT
AACTCCGCCCATCCTGATC -> ACTCCGCCCATCCTGATCA
AAGACTAGCAACACTTACT -> AGACTAGCAACACTTACTG
AAGATCAGCCGCGTACCCC -> AGATCAGCCGCGTACCCCT
AAGATTACACCAAAGATCA -> AGATTACACCAAAGATCAG
AAGATTCCGAAAAGCCGGC -> AGATTCCGAAAAGCCGGCC
AAGCATTTGACTTAACGTC -> AGCATTTGACTTAACGTCT
AAGCCGGCCATTTGGAGAT -> AGCCGGCCATTTGGAGATG
AAGCCTTCTCACAAGGCTG -> AGCCTTCTCACAAGGCTGA
AAGCGATGTGTACTCTTCG -> AGCGATGTGTACTCTTCGG
AAGCGCGAATGCAAGTCTG -> AGCGCGAATGCAAGTCTGG
AAGCGCGCAAGGAGACCTT -> AGCGCGCAAGGAGACCTTC
AAGCGTGCGAACGCCGAAG -> AGCGTGCGAACGCCGAAGC
AAGCTAACCTACATGCTAT -> AGCTAACCTACATGCTATA
AAGCTATCCGACAGTAGGG -> AGCTATCCGACAGTAGGGA
AAGCTCGCTACTATCGAAC -> AGCTCGCTACTATCGAACA
AAGGAATAATATCGATTCC -> AGGAATAATATCGATTCCC
AAGGAGACCTTCGTAGAAT -> AGGAGACCTTCGTAGAATT
AAGGATTTACTTCTAAGCT -> AGGATTTACTTCTAAGCTA
AAGGCTACGTGGTGCCTAT -> AGGCTACGTGGTGCCTATA
AAGGCTGATTCAGCACTTG -> AGGCTGATTCAGCACTTGC
AAGGGGACCACAAGTTTGT -> AGGGGACCACAAGTTTGTA
AAGGGGCGCCCCACACGGT -> AGGGGCGCCCCACACGGTG
AAGTACACAAGTATGTCGA -> AGTACACAAGTATGTCGAC
AAGTAGAGACAATGTATGA -> AGTAGAGACAATGTATGAG
AAGTAGGGATCCCCGCGGG -> AGTAGGGATCCCCGCGGGT
AAGTATGTCGACAGCCTAG -> AGTATGTCGACAGCCTAGG
AAGTCTAATTAGATTTCTT -> AGTCTAATTAGATTTCTTA
AAGTCTGGCTCACTTCCCA -> AGTCTGGCTCACTTCCCAC
AAGTGTGTGGCCCAGTTCA -> AGTGTGTGGCCCAGTTCAA
AAGTTTGTACCGGGGAGGC -> AGTTTGTACCGGGGAGGCT
AATAAAGCGATGTGTACTC -> ATAAAGCGATGTGTACTCT
AATAACAGCGTGGCCTGCC -> ATAACAGCGTGGCCTGCCT
AATAATATCGATTCCCACC -> ATAATATCGATTCCCACCC
AATAGACCGCCCAGGCCGC -> ATAGACCGCCCAGGCCGCG
AATAGCAACCCCCCTTCAG -> ATAGCAACCCCCCTTCAGA
AATAGCCTCCTGGTCGTAA -> ATAGCCTCCTGGTCGTAAA
AATAGGGATGAAAGCATTT -> ATAGGGATGAAAGCATTTG
AATAGTGCGCTCAACGCAA -> ATAGTGCGCTCAACGCAAA
AATATCAGCGCTCTGTCAG -> ATATCAGCGCTCTGTCAGT
AATATCGATTCCCACCCCG -> ATATCGATTCCCACCCCGT
AATATCTAGTGTCCCTGGT -> ATATCTAGTGTCCCTGGTC
AATATGATCACCGAGCTTT -> ATATGATCACCGAGCTTTC
AATCATTTATAATATGATC -> ATCATTTATAATATGATCA
AATCCAACGAAGGCTACGT -> ATCCAACGAAGGCTACGTG
AATCCAGGCCCATGGCATA -> ATCCAGGCCCATGGCATAG
AATCCATCTGTCACCCGCG -> ATCCATCTGTCACCCGCGT
AATCCTATCCCAGTGGCAC -> ATCCTATCCCAGTGGCACT
AATCGGCTCAACGCAAACC -> ATCGGCTCAACGCAAACCA
AATCTTTTCCTTTCCGTCG -> ATCTTTTCCTTTCCGTCGC
AATGAGGCAGAGGACCCCA -> ATGAGGCAGAGGACCCCAG
AATGCAAGTCTGGCTCACT -> ATGCAAGTCTGGCTCACTT
AATGGCCGCTTACCACCGC -> ATGGCCGCTTACCACCGCC
AATGGTAAAGTACACAAGT -> ATGGTAAAGTACACAAGTA
AATGTATGAGTGCATATTG -> ATGTATGAGTGCATATTGC
AATTAGATTTCTTACCCAG -> ATTAGATTTCTTACCCAGG
AATTAGCTAAGCCTTCTCA -> ATTAGCTAAGCCTTCTCAC
AATTCTTCCCATCGCCCGT -> ATTCTTCCCATCGCCCGTA
AATTCTTGTTTCCCACTAC -> ATTCTTGTTTCCCACTACT
AATTGCGGTATGAGTTATG -> ATTGCGGTATGAGTTATGT
ACAAAGACTAGCAACACTT -> CAAAGACTAGCAACACTTA
ACAAATAACAGCGTGGCCT -> CAAATAACAGCGTGGCCTG
ACAAATAGTGCGCTCAACG -> CAAATAGTGCGCTCAACGC
ACAAGATTACACCAAAGAT -> CAAGATTACACCAAAGATC
ACAAGGCTGATTCAGCACT -> CAAGGCTGATTCAGCACTT
ACAAGTATGTCGACAGCCT -> CAAGTATGTCGACAGCCTA
ACAAGTTTGTACCGGGGAG -> CAAGTTTGTACCGGGGAGG
ACAATCTTTTCCTTTCCGT -> CAATCTTTTCCTTTCCGTC
ACAATGTATGAGTGCATAT -> CAATGTATGAGTGCATATT
ACACAAGTATGTCGACAGC -> CACAAGTATGTCGACAGCC
ACACAATCTTTTCCTTTCC -> CACAATCTTTTCCTTTCCG
ACACAGCCTCGTAGTAGGG -> CACAGCCTCGTAGTAGGGA
ACACCAAAGATCAGCCGCG -> CACCAAAGATCAGCCGCGT
ACACCATCTTCTGAGTGAG -> CACCATCTTCTGAGTGAGT
ACACGAATGGTAAAGTACA -> CACGAATGGTAAAGTACAC
ACACGGTGTACAGCTCAAC -> CACGGTGTACAGCTCAACG
ACACGTCTTATGTTTAACT -> CACGTCTTATGTTTAACTC
ACACTTACTGGTTCGCGCT -> CACTTACTGGTTCGCGCTG
ACAGATTTTGCAAACATGG -> CAGATTTTGCAAACATGGA
ACAGCCTAGGCATGCAGGA -> CAGCCTAGGCATGCAGGAT
ACAGCCTCGTAGTAGGGAT -> CAGCCTCGTAGTAGGGATC
ACAGCGCTCCACCTATCCT -> CAGCGCTCCACCTATCCTC
ACAGCGTGGCCTGCCTCTG -> CAGCGTGGCCTGCCTCTGA
ACAGCTCAACGCAAACCAT -> CAGCTCAACGCAAACCATT
ACAGGGAGTCGGTTTACGA -> CAGGGAGTCGGTTTACGAA
ACAGTAGGGATCCCCGCGG -> CAGTAGGGATCCCCGCGGG
ACATACGGCTGAGTGGGGG -> CATACGGCTGAGTGGGGGG
ACATATGAGGAGGGGCCCA -> CATATGAGGAGGGGCCCAT
ACATCAACGTTGACCCTTA -> CATCAACGTTGACCCTTAA
ACATCATGGTAACCCGGGA -> CATCATGGTAACCCGGGAT
ACATCGATAACCAATGAGG -> CATCGATAACCAATGAGGC
ACATGCTATAGGATACCTT -> CATGCTATAGGATACCTTG
ACATGGAACGCACGACTAG -> CATGGAACGCACGACTAGG
ACATTTTACCTCCGGGGAT -> CATTTTACCTCCGGGGATT
ACCAAAGATCAGCCGCGTA -> CCAAAGATCAGCCGCGTAC
ACCAATGAGGCAGAGGACC -> CCAATGAGGCAGAGGACCC
ACCACAAGTTTGTACCGGG -> CCACAAGTTTGTACCGGGG
ACCACCGCCGTCACCGCCT -> CCACCGCCGTCACCGCCTC
ACCACCGTCTCCCTAACTC -> CCACCGTCTCCCTAACTCC
ACCATAAGGAATAATATCG -> CCATAAGGAATAATATCGA
ACCATCTTCTGAGTGAGTT -> CCATCTTCTGAGTGAGTTA
ACCATGCCTTCGTTTCAGT -> CCATGCCTTCGTTTCAGTT
ACCATGCTCGAGGTACAGA -> CCATGCTCGAGGTACAGAT
ACCATTAAGCTATCCGACA -> CCATTAAGCTATCCGACAG
ACCATTACACAGCCTCGTA -> CCATTACACAGCCTCGTAG
ACCATTAGACGACGCTCAA -> CCATTAGACGACGCTCAAG
ACCATTATCGGTGCTGTTA -> CCATTATCGGTGCTGTTAG
ACCCAGGACGATCGTCTTA -> CCCAGGACGATCGTCTTAC
ACCCCAGACACGAATGGTA -> CCCCAGACACGAATGGTAA
ACCCCCCTTCAGACTAAAC -> CCCCCCTTCAGACTAAACA
ACCCCGCAGTGCGTCAAGG -> CCCCGCAGTGCGTCAAGGG
ACCCCGTCTCTGGATGTGC -> CCCCGTCTCTGGATGTGCT
ACCCCGTTATAAGATTCCG -> CCCCGTTATAAGATTCCGA
ACCCCTCTGTTATGTCTCA -> CCCCTCTGTTATGTCTCAG
ACCCCTGAATCCATCTGTC -> CCCCTGAATCCATCTGTCA
ACCCCTTTGAATAGCCTCC -> CCCCTTTGAATAGCCTCCT
ACCCGCCGTGCACGAAGGG -> CCCGCCGTGCACGAAGGGG
ACCCGCGTAGGAGCGTCAC -> CCCGCGTAGGAGCGTCACT
ACCCGGGATTAGCTTCTCC -> CCCGGGATTAGCTTCTCCG
ACCCTTAACCGTCGTACGA -> CCCTTAACCGTCGTACGAG
ACCGAACGTTGGGAGGCGC -> CCGAACGTTGGGAGGCGCG
ACCGAGCTTTCACGGAGAT -> CCGAGCTTTCACGGAGATG
ACCGCCCAGGCCGCGGCCT -> CCGCCCAGGCCGCGGCCTC
ACCGCCGTCACCGCCTCCT -> CCGCCGTCACCGCCTCCTT
ACCGCCTCCTTTGTCTGAC -> CCGCCTCCTTTGTCTGACT
ACCGCTTCCTTGGGCTGAA -> CCGCTTCCTTGGGCTGAAA
ACCGCTTGTGACCCCGCAG -> CCGCTTGTGACCCCGCAGT
ACCGGGGAGGCTCGGGGCC -> CCGGGGAGGCTCGGGGCCA
ACCGTCGTACGAGCGCCCT -> CCGTCGTACGAGCGCCCTA
ACCGTCTCCCTAACTCCGC -> CCGTCTCCCTAACTCCGCC
ACCTACATGCTATAGGATA -> CCTACATGCTATAGGATAC
ACCTATCCTCGGAAACTAG -> CCTATCCTCGGAAACTAGT
ACCTCCGGGGATTTCAATT -> CCTCCGGGGATTTCAATTA
ACCTGTCTCCAAACTCCAT -> CCTGTCTCCAAACTCCATT
ACCTTCGTAGAATTGCGGT -> CCTTCGTAGAATTGCGGTA
ACCTTGGTATACCCCGTTA -> CCTTGGTATACCCCGTTAT
ACGAACCACCGTCTCCCTA -> CGAACCACCGTCTCCCTAA
ACGAAGGCTACGTGGTGCC -> CGAAGGCTACGTGGTGCCT
ACGAAGGGGACCACAAGTT -> CGAAGGGGACCACAAGTTT
ACGAATGGTAAAGTACACA -> CGAATGGTAAAGTACACAA
ACGACGCCTATGCGAAGCT -> CGACGCCTATGCGAAGCTC
ACGACGCTCAAGTAGGGAT -> CGACGCTCAAGTAGGGATC
ACGACGGACCATAAGGAAT -> CGACGGACCATAAGGAATA
ACGACTAGGTGCCTCAGCA -> CGACTAGGTGCCTCAGCAA
ACGAGCGCCCTAGGAATAT -> CGAGCGCCCTAGGAATATC
ACGAGGTGTATCATAGACC -> CGAGGTGTATCATAGACCG
ACGATACCATGCCTTCGTT -> CGATACCATGCCTTCGTTT
ACGATCGTCTTACGTCAAC -> CGATCGTCTTACGTCAACT
ACGCAAACCATTAAGCTAT -> CGCAAACCATTAAGCTATC
ACGCAAACCATTACACAGC -> CGCAAACCATTACACAGCC
ACGCAAACCATTAGACGAC -> CGCAAACCATTAGACGACG
ACGCAAACCATTATCGGTG -> CGCAAACCATTATCGGTGC
ACGCACGACTAGGTGCCTC -> CGCACGACTAGGTGCCTCA
ACGCCGAAGCGCGCAAGGA -> CGCCGAAGCGCGCAAGGAG
ACGCCTATGCGAAGCTCGC -> CGCCTATGCGAAGCTCGCT
ACGCTCAAGTAGGGATCCC -> CGCTCAAGTAGGGATCCCC
ACGGACCATAAGGAATAAT -> CGGACCATAAGGAATAATA
ACGGAGATGCCAGACACGT -> CGGAGATGCCAGACACGTC
ACGGAGGACGGTTCTTTTG -> CGGAGGACGGTTCTTTTGA
ACGGCTGAGTGGGGGGAGT -> CGGCTGAGTGGGGGGAGTT
ACGGGTTCTGGGTGGAGGC -> CGGGTTCTGGGTGGAGGCT
ACGGTAACAAATAACAGCG -> CGGTAACAAATAACAGCGT
ACGGTACTGGGTGCAATCC -> CGGTACTGGGTGCAATCCA
ACGGTATGCCTTGGGGAAT -> CGGTATGCCTTGGGGAATC
ACGGTGTACAGCTCAACGC -> CGGTGTACAGCTCAACGCA
ACGGTGTATTGCCACTGTA -> CGGTGTATTGCCACTGTAT
ACGGTTCTTTTGAATATCT -> CGGTTCTTTTGAATATCTA
ACGTCAACTACATTTTACC -> CGTCAACTACATTTTACCT
ACGTCTATTCATAACGGTA -> CGTCTATTCATAACGGTAC
ACGTCTTATGTTTAACTCA -> CGTCTTATGTTTAACTCAC
ACGTGCACTGATGCACTTT -> CGTGCACTGATGCACTTTC
ACGTGGTGCCTATATTCGT -> CGTGGTGCCTATATTCGTA
ACGTTGACCCTTAACCGTC -> CGTTGACCCTTAACCGTCG
ACGTTGGGAGGCGCGTTTA -> CGTTGGGAGGCGCGTTTAT
ACTAAACATATGAGGAGGG -> CTAAACATATGAGGAGGGG
ACTACATTTTACCTCCGGG -> CTACATTTTACCTCCGGGG
ACTACTCACAAGATTACAC -> CTACTCACAAGATTACACC
ACTAGCAACACTTACTGGT -> CTAGCAACACTTACTGGTT
ACTAGGTGCCTCAGCAACC -> CTAGGTGCCTCAGCAACCG
ACTAGTACGACGGACCATA -> CTAGTACGACGGACCATAA
ACTATCGAACAGGGAGTCG -> CTATCGAACAGGGAGTCGG
ACTCACAAGATTACACCAA -> CTCACAAGATTACACCAAA
ACTCACATCAACGTTGACC -> CTCACATCAACGTTGACCC
ACTCCATTGTACGTGCACT -> CTCCATTGTACGTGCACTG
ACTCCGCCCATCCTGATCA -> CTCCGCCCATCCTGATCAA
ACTCGATCTGTATGGGACC -> CTCGATCTGTATGGGACCA
ACTCTTCGGACGATACCAT -> CTCTTCGGACGATACCATG
ACTGAATCCAACGAAGGCT -> CTGAATCCAACGAAGGCTA
ACTGACTCGATCTGTATGG -> CTGACTCGATCTGTATGGG
ACTGATGCACTTTCGCCGT -> CTGATGCACTTTCGCCGTT
ACTGCACGACGCCTATGCG -> CTGCACGACGCCTATGCGA
ACTGCAGAGTGATCGTTAA -> CTGCAGAGTGATCGTTAAT
ACTGGGTGCAATCCAGGCC -> CTGGGTGCAATCCAGGCCC
ACTGGTTCGCGCTGCCGTC -> CTGGTTCGCGCTGCCGTCT
ACTGTATGTCATTCGATGT -> CTGTATGTCATTCGATGTG
ACTTAACGTCTATTCATAA -> CTTAACGTCTATTCATAAC
ACTTACTGGTTCGCGCTGC -> CTTACTGGTTCGCGCTGCC
ACTTCAGGGACGGTATGCC -> CTTCAGGGACGGTATGCCT
ACTTCATGGGTGGTTGCTA -> CTTCATGGGTGGTTGCTAT
ACTTCCCACGGTAACAAAT -> CTTCCCACGGTAACAAATA
ACTTCTAAGCTAACCTACA -> CTTCTAAGCTAACCTACAT
ACTTGCTCAACGCAAACCA -> CTTGCTCAACGCAAACCAT
ACTTTCGCCGTTGTATGCA -> CTTTCGCCGTTGTATGCAT
AGAATAGACCGCCCAGGCC -> GAATAGACCGCCCAGGCCG
AGAATTGCGGTATGAGTTA -> GAATTGCGGTATGAGTTAT
AGACAATGTATGAGTGCAT -> GACAATGTATGAGTGCATA
AGACACGAATGGTAAAGTA -> GACACGAATGGTAAAGTAC
AGACACGTCTTATGTTTAA -> GACACGTCTTATGTTTAAC
AGACCGCCCAGGCCGCGGC -> GACCGCCCAGGCCGCGGCC
AGACCGCTTCCTTGGGCTG -> GACCGCTTCCTTGGGCTGA
AGACCTTCGTAGAATTGCG -> GACCTTCGTAGAATTGCGG
AGACGACGCTCAAGTAGGG -> GACGACGCTCAAGTAGGGA
AGACTAAACATATGAGGAG -> GACTAAACATATGAGGAGG
AGACTAGCAACACTTACTG -> GACTAGCAACACTTACTGG
AGAGACAATGTATGAGTGC -> GAGACAATGTATGAGTGCA
AGAGGACCCCAGACACGAA -> GAGGACCCCAGACACGAAT
AGAGTGATCGTTAATTCTT -> GAGTGATCGTTAATTCTTC
AGATCAGCCGCGTACCCCT -> GATCAGCCGCGTACCCCTC
AGATGCCAGACACGTCTTA -> GATGCCAGACACGTCTTAT
AGATGCTCATTAATAAAGC -> GATGCTCATTAATAAAGCG
AGATTACACCAAAGATCAG -> GATTACACCAAAGATCAGC
AGATTCCGAAAAGCCGGCC -> GATTCCGAAAAGCCGGCCA
AGATTTCTTACCCAGGACG -> GATTTCTTACCCAGGACGA
AGATTTTGCAAACATGGAA -> GATTTTGCAAACATGGAAC
AGCAACACTTACTGGTTCG -> GCAACACTTACTGGTTCGC
AGCAACCCCCCTTCAGACT -> GCAACCCCCCTTCAGACTA
AGCAACCGAACGTTGGGAG -> GCAACCGAACGTTGGGAGG
AGCACTTGCTCAACGCAAA -> GCACTTGCTCAACGCAAAC
AGCAGTTACCCCTTTGAAT -> GCAGTTACCCCTTTGAATA
AGCATTTGACTTAACGTCT -> GCATTTGACTTAACGTCTA
AGCCCGCACCCCTGAATCC -> GCCCGCACCCCTGAATCCA
AGCCGAAACAGCGCTCCAC -> GCCGAAACAGCGCTCCACC
AGCCGCGTACCCCTCTGTT -> GCCGCGTACCCCTCTGTTA
AGCCGGCCATTTGGAGATG -> GCCGGCCATTTGGAGATGC
AGCCTAGGCATGCAGGATG -> GCCTAGGCATGCAGGATGA
AGCCTCCTGGTCGTAAACC -> GCCTCCTGGTCGTAAACCT
AGCCTCGTAGTAGGGATCC -> GCCTCGTAGTAGGGATCCC
AGCCTTCTCACAAGGCTGA -> GCCTTCTCACAAGGCTGAT
AGCGATGTGTACTCTTCGG -> GCGATGTGTACTCTTCGGA
AGCGCCCTAGGAATATCAG -> GCGCCCTAGGAATATCAGC
AGCGCCTGATGCCTTCGAG -> GCGCCTGATGCCTTCGAGG
AGCGCGAATGCAAGTCTGG -> GCGCGAATGCAAGTCTGGC
AGCGCGCAAGGAGACCTTC -> GCGCGCAAGGAGACCTTCG
AGCGCTCCACCTATCCTCG -> GCGCTCCACCTATCCTCGG
AGCGCTCTGTCAGTATCCC -> GCGCTCTGTCAGTATCCCG
AGCGGTCTATGTGCATTAC -> GCGGTCTATGTGCATTACC
AGCGTCACTGCAGAGTGAT -> GCGTCACTGCAGAGTGATC
AGCGTGCGAACGCCGAAGC -> GCGTGCGAACGCCGAAGCG
AGCGTGGCCTGCCTCTGAG -> GCGTGGCCTGCCTCTGAGT
AGCTAACCTACATGCTATA -> GCTAACCTACATGCTATAG
AGCTAAGCCTTCTCACAAG -> GCTAAGCCTTCTCACAAGG
AGCTATCCGACAGTAGGGA -> GCTATCCGACAGTAGGGAT
AGCTCAACGCAAACCATTA -> GCTCAACGCAAACCATTAA
AGCTCGCTACTATCGAACA -> GCTCGCTACTATCGAACAG
AGCTTCTCCGTTTTCATTC -> GCTTCTCCGTTTTCATTCG
AGCTTTCACGGAGATGCCA -> GCTTTCACGGAGATGCCAG
AGGAATAATATCGATTCCC -> GGAATAATATCGATTCCCA
AGGAATATCAGCGCTCTGT -> GGAATATCAGCGCTCTGTC
AGGACCCCAGACACGAATG -> GGACCCCAGACACGAATGG
AGGACGATCGTCTTACGTC -> GGACGATCGTCTTACGTCA
AGGACGGTTCTTTTGAATA -> GGACGGTTCTTTTGAATAT
AGGAGACCTTCGTAGAATT -> GGAGACCTTCGTAGAATTG
AGGAGCGTCACTGCAGAGT -> GGAGCGTCACTGCAGAGTG
AGGAGGCCCGACGGTGTAT -> GGAGGCCCGACGGTGTATT
AGGAGGGGCCCATTGAACA -> GGAGGGGCCCATTGAACAT
AGGATACCTTGGTATACCC -> GGATACCTTGGTATACCCC
AGGATGAAATTCTTGTTTC -> GGATGAAATTCTTGTTTCC
AGGATTTACTTCTAAGCTA -> GGATTTACTTCTAAGCTAA
AGGCAGAGGACCCCAGACA -> GGCAGAGGACCCCAGACAC
AGGCATGCAGGATGAAATT -> GGCATGCAGGATGAAATTC
AGGCCCATGGCATAGCGCC -> GGCCCATGGCATAGCGCCT
AGGCCCGACGGTGTATTGC -> GGCCCGACGGTGTATTGCC
AGGCGCGTTTATGGATCTC -> GGCGCGTTTATGGATCTCA
AGGCTAAATAGCAACCCCC -> GGCTAAATAGCAACCCCCC
AGGCTACGTGGTGCCTATA -> GGCTACGTGGTGCCTATAT
AGGCTCGGGGCCAAAGTAG -> GGCTCGGGGCCAAAGTAGA
AGGCTGATTCAGCACTTGC -> GGCTGATTCAGCACTTGCT
AGGGACGGTATGCCTTGGG -> GGGACGGTATGCCTTGGGG
AGGGAGTCGGTTTACGAAC -> GGGAGTCGGTTTACGAACC
AGGGATCCCCGCGGGTATG -> GGGATCCCCGCGGGTATGT
AGGGATCCCCGCGGGTCTG -> GGGATCCCCGCGGGTCTGA
AGGGATCCCCGCGGGTTCC -> GGGATCCCCGCGGGTTCCC
AGGGATCCCCGCGGGTTTA -> GGGATCCCCGCGGGTTTAC
AGGGATGAAAGCATTTGAC -> GGGATGAAAGCATTTGACT
AGGGGACCACAAGTTTGTA -> GGGGACCACAAGTTTGTAC
AGGGGCCCATTGAACATAC -> GGGGCCCATTGAACATACG
AGGGGCGCCCCACACGGTG -> GGGGCGCCCCACACGGTGT
AGGTACAGATTTTGCAAAC -> GGTACAGATTTTGCAAACA
AGGTGCCTCAGCAACCGAA -> GGTGCCTCAGCAACCGAAC
AGGTGTATCATAGACCGCT -> GGTGTATCATAGACCGCTT
AGTACACAAGTATGTCGAC -> GTACACAAGTATGTCGACA
AGTACGACGGACCATAAGG -> GTACGACGGACCATAAGGA
AGTACGGGTTCTGGGTGGA -> GTACGGGTTCTGGGTGGAG
AGTACTTCATGGGTGGTTG -> GTACTTCATGGGTGGTTGC
AGTAGAGACAATGTATGAG -> GTAGAGACAATGTATGAGT
AGTAGGGATCCCCGCGGGT -> GTAGGGATCCCCGCGGGTA,GTAGGGATCCCCGCGGGTC,GTAGGGATCCCCGCGGGTT,GTAGGGATCCCCGCGGGTT
AGTATCCCGCAATGGCCGC -> GTATCCCGCAATGGCCGCT
AGTATGTCGACAGCCTAGG -> GTATGTCGACAGCCTAGGC
AGTCGGTTTACGAACCACC -> GTCGGTTTACGAACCACCG
AGTCTAATTAGATTTCTTA -> GTCTAATTAGATTTCTTAC
AGTCTGGCTCACTTCCCAC -> GTCTGGCTCACTTCCCACG
AGTGAGTTAGCAGTTACCC -> GTGAGTTAGCAGTTACCCC
AGTGATCGTTAATTCTTCC -> GTGATCGTTAATTCTTCCC
AGTGCATATTGCAAGTGTG -> GTGCATATTGCAAGTGTGT
AGTGCGCTCAACGCAAACC -> GTGCGCTCAACGCAAACCA
AGTGCGTCAAGGGGCGCCC -> GTGCGTCAAGGGGCGCCCC
AGTGGCACTGACTCGATCT -> GTGGCACTGACTCGATCTG
AGTGGGGGGAGTTTATAAT -> GTGGGGGGAGTTTATAATC
AGTGTCCCTGGTCTTTGCC -> GTGTCCCTGGTCTTTGCCC
AGTGTGTGGCCCAGTTCAA -> GTGTGTGGCCCAGTTCAAG
AGTTACCCCTTTGAATAGC -> GTTACCCCTTTGAATAGCC
AGTTAGAATAGACCGCCCA -> GTTAGAATAGACCGCCCAG
AGTTAGCAGTTACCCCTTT -> GTTAGCAGTTACCCCTTTG
AGTTATGTTCTCCGAATAG -> GTTATGTTCTCCGAATAGG
AGTTCAAGGATTTACTTCT -> GTTCAAGGATTTACTTCTA
AGTTTATAATCATTTATAA -> GTTTATAATCATTTATAAT
AGTTTGTACCGGGGAGGCT -> GTTTGTACCGGGGAGGCTC
ATAAAGCGATGTGTACTCT -> TAAAGCGATGTGTACTCTT
ATAACAGCGTGGCCTGCCT -> TAACAGCGTGGCCTGCCTC
ATAACCAATGAGGCAGAGG -> TAACCAATGAGGCAGAGGA
ATAACGGTACTGGGTGCAA -> TAACGGTACTGGGTGCAAT
ATAAGATTCCGAAAAGCCG -> TAAGATTCCGAAAAGCCGG
ATAAGGAATAATATCGATT -> TAAGGAATAATATCGATTC
ATAAGTCTAATTAGATTTC -> TAAGTCTAATTAGATTTCT
ATAATATCGATTCCCACCC -> TAATATCGATTCCCACCCC
ATAATATGATCACCGAGCT -> TAATATGATCACCGAGCTT
ATAATCATTTATAATATGA -> TAATCATTTATAATATGAT
ATACCATGCCTTCGTTTCA -> TACCATGCCTTCGTTTCAG
ATACCCCGTTATAAGATTC -> TACCCCGTTATAAGATTCC
ATACCTTGGTATACCCCGT -> TACCTTGGTATACCCCGTT
ATACGGCTGAGTGGGGGGA -> TACGGCTGAGTGGGGGGAG
ATAGACCGCCCAGGCCGCG -> TAGACCGCCCAGGCCGCGG
ATAGACCGCTTCCTTGGGC -> TAGACCGCTTCCTTGGGCT
ATAGCAACCCCCCTTCAGA -> TAGCAACCCCCCTTCAGAC
ATAGCCTCCTGGTCGTAAA -> TAGCCTCCTGGTCGTAAAC
ATAGCGCCTGATGCCTTCG -> TAGCGCCTGATGCCTTCGA
ATAGGATACCTTGGTATAC -> TAGGATACCTTGGTATACC
ATAGGGATGAAAGCATTTG -> TAGGGATGAAAGCATTTGA
ATAGTGCGCTCAACGCAAA -> TAGTGCGCTCAACGCAAAC
ATATCAGCGCTCTGTCAGT -> TATCAGCGCTCTGTCAGTA
ATATCGATTCCCACCCCGT -> TATCGATTCCCACCCCGTC
ATATCTAGTGTCCCTGGTC -> TATCTAGTGTCCCTGGTCT
ATATGAGGAGGGGCCCATT -> TATGAGGAGGGGCCCATTG
ATATGATCACCGAGCTTTC -> TATGATCACCGAGCTTTCA
ATATGGCCCTCCCGTGACT -> TATGGCCCTCCCGTGACTT
ATATTCGTATCGAACACAA -> TATTCGTATCGAACACAAT
ATATTGCAAGTGTGTGGCC -> TATTGCAAGTGTGTGGCCC
ATCAACGTTGACCCTTAAC -> TCAACGTTGACCCTTAACC
ATCAAGCGCGAATGCAAGT -> TCAAGCGCGAATGCAAGTC
ATCACCGAGCTTTCACGGA -> TCACCGAGCTTTCACGGAG
ATCAGCCGCGTACCCCTCT -> TCAGCCGCGTACCCCTCTG
ATCAGCGCTCTGTCAGTAT -> TCAGCGCTCTGTCAGTATC
ATCATAGACCGCTTCCTTG -> TCATAGACCGCTTCCTTGG
ATCATGGTAACCCGGGATT -> TCATGGTAACCCGGGATTA
ATCATTTATAATATGATCA -> TCATTTATAATATGATCAC
ATCATTTGTCAGTACGGGT -> TCATTTGTCAGTACGGGTT
ATCCAACGAAGGCTACGTG -> TCCAACGAAGGCTACGTGG
ATCCAGGCCCATGGCATAG -> TCCAGGCCCATGGCATAGC
ATCCATCTGTCACCCGCGT -> TCCATCTGTCACCCGCGTA
ATCCCAGTGGCACTGACTC -> TCCCAGTGGCACTGACTCG
ATCCCCGCGGGTATGTTGT -> TCCCCGCGGGTATGTTGTT
ATCCCCGCGGGTCTGACTG -> TCCCCGCGGGTCTGACTGC
ATCCCCGCGGGTTCCCGCA -> TCCCCGCGGGTTCCCGCAT
ATCCCCGCGGGTTTACGGA -> TCCCCGCGGGTTTACGGAG
ATCCCGCAATGGCCGCTTA -> TCCCGCAATGGCCGCTTAC
ATCCGACAGTAGGGATCCC -> TCCGACAGTAGGGATCCCC
ATCCTATCCCAGTGGCACT -> TCCTATCCCAGTGGCACTG
ATCCTCGGAAACTAGTACG -> TCCTCGGAAACTAGTACGA
ATCCTGATCAAGCGCGAAT -> TCCTGATCAAGCGCGAATG
ATCGAACACAATCTTTTCC -> TCGAACACAATCTTTTCCT
ATCGAACAGGGAGTCGGTT -> TCGAACAGGGAGTCGGTTT
ATCGATAACCAATGAGGCA -> TCGATAACCAATGAGGCAG
ATCGATTCCCACCCCGTCT -> TCGATTCCCACCCCGTCTC
ATCGCCCGTAAAACGAGGT -> TCGCCCGTAAAACGAGGTG
ATCGGCTCAACGCAAACCA -> TCGGCTCAACGCAAACCAT
ATCGGTGCTGTTAGTAGGG -> TCGGTGCTGTTAGTAGGGA
ATCGTCTTACGTCAACTAC -> TCGTCTTACGTCAACTACA
ATCGTTAATTCTTCCCATC -> TCGTTAATTCTTCCCATCG
ATCTAGTGTCCCTGGTCTT -> TCTAGTGTCCCTGGTCTTT
ATCTCATTTCCATAAGTCT -> TCTCATTTCCATAAGTCTA
ATCTGTATGGGACCATGCT -> TCTGTATGGGACCATGCTC
ATCTGTCACCCGCGTAGGA -> TCTGTCACCCGCGTAGGAG
ATCTTCTGAGTGAGTTAGC -> TCTTCTGAGTGAGTTAGCA
ATCTTTTCCTTTCCGTCGC -> TCTTTTCCTTTCCGTCGCG
ATGAAAGCATTTGACTTAA -> TGAAAGCATTTGACTTAAC
ATGAAATTCTTGTTTCCCA -> TGAAATTCTTGTTTCCCAC
ATGAGGAGGGGCCCATTGA -> TGAGGAGGGGCCCATTGAA
ATGAGGCAGAGGACCCCAG -> TGAGGCAGAGGACCCCAGA
ATGAGTGCATATTGCAAGT -> TGAGTGCATATTGCAAGTG
ATGAGTTATGTTCTCCGAA -> TGAGTTATGTTCTCCGAAT
ATGATCACCGAGCTTTCAC -> TGATCACCGAGCTTTCACG
ATGCAAGTCTGGCTCACTT -> TGCAAGTCTGGCTCACTTC
ATGCACTTTCGCCGTTGTA -> TGCACTTTCGCCGTTGTAT
ATGCAGGATGAAATTCTTG -> TGCAGGATGAAATTCTTGT
ATGCATGGAAACATCATGG -> TGCATGGAAACATCATGGT
ATGCCAGACACGTCTTATG -> TGCCAGACACGTCTTATGT
ATGCCGACACCATCTTCTG -> TGCCGACACCATCTTCTGA
ATGCCTTCGAGGAGGCCCG -> TGCCTTCGAGGAGGCCCGA
ATGCCTTCGTTTCAGTTAG -> TGCCTTCGTTTCAGTTAGA
ATGCCTTGGGGAATCGGCT -> TGCCTTGGGGAATCGGCTC
ATGCGAAGCTCGCTACTAT -> TGCGAAGCTCGCTACTATC
ATGCTATAGGATACCTTGG -> TGCTATAGGATACCTTGGT
ATGCTCATTAATAAAGCGA -> TGCTCATTAATAAAGCGAT
ATGCTCGAGGTACAGATTT -> TGCTCGAGGTACAGATTTT
ATGGAAACATCATGGTAAC -> TGGAAACATCATGGTAACC
ATGGAACGCACGACTAGGT -> TGGAACGCACGACTAGGTG
ATGGATCTCATTTCCATAA -> TGGATCTCATTTCCATAAG
ATGGCATAGCGCCTGATGC -> TGGCATAGCGCCTGATGCC
ATGGCCCTCCCGTGACTTC -> TGGCCCTCCCGTGACTTCA
ATGGCCGCTTACCACCGCC -> TGGCCGCTTACCACCGCCG
ATGGGACCATGCTCGAGGT -> TGGGACCATGCTCGAGGTA
ATGGGTGGTTGCTATTTGG -> TGGGTGGTTGCTATTTGGC
ATGGTAAAGTACACAAGTA -> TGGTAAAGTACACAAGTAT
ATGGTAACCCGGGATTAGC -> TGGTAACCCGGGATTAGCT
ATGTATGAGTGCATATTGC -> TGTATGAGTGCATATTGCA
ATGTCATTCGATGTGTAGC -> TGTCATTCGATGTGTAGCC
ATGTCGACAGCCTAGGCAT -> TGTCGACAGCCTAGGCATG
ATGTCTCAGCGGTCTATGT -> TGTCTCAGCGGTCTATGTG
ATGTGCATTACCGCTTGTG -> TGTGCATTACCGCTTGTGA
ATGTGCTAACAAAGACTAG -> TGTGCTAACAAAGACTAGC
ATGTGTACTCTTCGGACGA -> TGTGTACTCTTCGGACGAT
ATGTGTAGCCGAAACAGCG -> TGTGTAGCCGAAACAGCGC
ATGTTCTCCGAATAGGGAT -> TGTTCTCCGAATAGGGATG
ATGTTGTTACCCGCCGTGC -> TGTTGTTACCCGCCGTGCA
ATGTTTAACTCACATCAAC -> TGTTTAACTCACATCAACG
ATTAAGCTATCCGACAGTA -> TTAAGCTATCCGACAGTAG
ATTAATAAAGCGATGTGTA -> TTAATAAAGCGATGTGTAC
ATTACACAGCCTCGTAGTA -> TTACACAGCCTCGTAGTAG
ATTACACCAAAGATCAGCC -> TTACACCAAAGATCAGCCG
ATTACCGCTTGTGACCCCG -> TTACCGCTTGTGACCCCGC
ATTAGACGACGCTCAAGTA -> TTAGACGACGCTCAAGTAG
ATTAGATTTCTTACCCAGG -> TTAGATTTCTTACCCAGGA
ATTAGCTAAGCCTTCTCAC -> TTAGCTAAGCCTTCTCACA
ATTAGCTTCTCCGTTTTCA -> TTAGCTTCTCCGTTTTCAT
ATTATCGGTGCTGTTAGTA -> TTATCGGTGCTGTTAGTAG
ATTCAGCACTTGCTCAACG -> TTCAGCACTTGCTCAACGC
ATTCATAACGGTACTGGGT -> TTCATAACGGTACTGGGTG
ATTCCCACCCCGTCTCTGG -> TTCCCACCCCGTCTCTGGA
ATTCCGAAAAGCCGGCCAT -> TTCCGAAAAGCCGGCCATT
ATTCGATGTGTAGCCGAAA -> TTCGATGTGTAGCCGAAAC
ATTCGTATCGAACACAATC -> TTCGTATCGAACACAATCT
ATTCGTTAGCCCGCACCCC -> TTCGTTAGCCCGCACCCCT
ATTCTTCCCATCGCCCGTA -> TTCTTCCCATCGCCCGTAA
ATTCTTGTTTCCCACTACT -> TTCTTGTTTCCCACTACTC
ATTGAACATACGGCTGAGT -> TTGAACATACGGCTGAGTG
ATTGATATGGCCCTCCCGT -> TTGATATGGCCCTCCCGTG
ATTGCAAGTGTGTGGCCCA -> TTGCAAGTGTGTGGCCCAG
ATTGCCACTGTATGTCATT -> TTGCCACTGTATGTCATTC
ATTGCGGTATGAGTTATGT -> TTGCGGTATGAGTTATGTT
ATTGTACGTGCACTGATGC -> TTGTACGTGCACTGATGCA
ATTTACTTCTAAGCTAACC -> TTTACTTCTAAGCTAACCT
ATTTATAATATGATCACCG -> TTTATAATATGATCACCGA
ATTTCAATTAGCTAAGCCT -> TTTCAATTAGCTAAGCCTT
ATTTCCATAAGTCTAATTA -> TTTCCATAAGTCTAATTAG
ATTTCTTACCCAGGACGAT -> TTTCTTACCCAGGACGATC
ATTTGACTTAACGTCTATT -> TTTGACTTAACGTCTATTC
ATTTGGAGATGCTCATTAA -> TTTGGAGATGCTCATTAAT
ATTTGGCTACATCGATAAC -> TTTGGCTACATCGATAACC
ATTTGTCAGTACGGGTTCT -> TTTGTCAGTACGGGTTCTG
ATTTTACCTCCGGGGATTT -> TTTTACCTCCGGGGATTTC
ATTTTGCAAACATGGAACG -> TTTTGCAAACATGGAACGC
CAAACATGGAACGCACGAC -> AAACATGGAACGCACGACT
CAAACCATTAAGCTATCCG -> AAACCATTAAGCTATCCGA
CAAACCATTACACAGCCTC -> AAACCATTACACAGCCTCG
CAAACCATTAGACGACGCT -> AAACCATTAGACGACGCTC
CAAACCATTATCGGTGCTG -> AAACCATTATCGGTGCTGT
CAAACTCCATTGTACGTGC -> AAACTCCATTGTACGTGCA
CAAAGACTAGCAACACTTA -> AAAGACTAGCAACACTTAC
CAAAGATCAGCCGCGTACC -> AAAGATCAGCCGCGTACCC
CAAAGTAGAGACAATGTAT -> AAAGTAGAGACAATGTATG
CAAATAACAGCGTGGCCTG -> AAATAACAGCGTGGCCTGC
CAAATAGTGCGCTCAACGC -> AAATAGTGCGCTCAACGCA
CAACACTTACTGGTTCGCG -> AACACTTACTGGTTCGCGC
CAACCCCCCTTCAGACTAA -> AACCCCCCTTCAGACTAAA
CAACCGAACGTTGGGAGGC -> AACCGAACGTTGGGAGGCG
CAACGAAGGCTACGTGGTG -> AACGAAGGCTACGTGGTGC
CAACGCAAACCATTAAGCT -> AACGCAAACCATTAAGCTA
CAACGCAAACCATTACACA -> AACGCAAACCATTACACAG
CAACGCAAACCATTAGACG -> AACGCAAACCATTAGACGA
CAACGCAAACCATTATCGG -> AACGCAAACCATTATCGGT
CAACGTTGACCCTTAACCG -> AACGTTGACCCTTAACCGT
CAACTACATTTTACCTCCG -> AACTACATTTTACCTCCGG
CAAGATTACACCAAAGATC -> AAGATTACACCAAAGATCA
CAAGCGCGAATGCAAGTCT -> AAGCGCGAATGCAAGTCTG
CAAGGAGACCTTCGTAGAA -> AAGGAGACCTTCGTAGAAT
CAAGGATTTACTTCTAAGC -> AAGGATTTACTTCTAAGCT
CAAGGCTGATTCAGCACTT -> AAGGCTGATTCAGCACTTG
CAAGGGGCGCCCCACACGG -> AAGGGGCGCCCCACACGGT
CAAGTAGGGATCCCCGCGG -> AAGTAGGGATCCCCGCGGG
CAAGTATGTCGACAGCCTA -> AAGTATGTCGACAGCCTAG
CAAGTCTGGCTCACTTCCC -> AAGTCTGGCTCACTTCCCA
CAAGTGTGTGGCCCAGTTC -> AAGTGTGTGGCCCAGTTCA
CAAGTTTGTACCGGGGAGG -> AAGTTTGTACCGGGGAGGC
CAATCCAGGCCCATGGCAT -> AATCCAGGCCCATGGCATA
CAATCTTTTCCTTTCCGTC -> AATCTTTTCCTTTCCGTCG
CAATGAGGCAGAGGACCCC -> AATGAGGCAGAGGACCCCA
CAATGGCCGCTTACCACCG -> AATGGCCGCTTACCACCGC
CAATGTATGAGTGCATATT -> AATGTATGAGTGCATATTG
CAATTAGCTAAGCCTTCTC -> AATTAGCTAAGCCTTCTCA
CACAAGATTACACCAAAGA -> ACAAGATTACACCAAAGAT
CACAAGGCTGATTCAGCAC -> ACAAGGCTGATTCAGCACT
CACAAGTATGTCGACAGCC -> ACAAGTATGTCGACAGCCT
CACAAGTTTGTACCGGGGA -> ACAAGTTTGTACCGGGGAG
CACAATCTTTTCCTTTCCG -> ACAATCTTTTCCTTTCCGT
CACACGGTGTACAGCTCAA -> ACACGGTGTACAGCTCAAC
CACAGCCTCGTAGTAGGGA -> ACAGCCTCGTAGTAGGGAT
CACATCAACGTTGACCCTT -> ACATCAACGTTGACCCTTA
CACCAAAGATCAGCCGCGT -> ACCAAAGATCAGCCGCGTA
CACCATCTTCTGAGTGAGT -> ACCATCTTCTGAGTGAGTT
CACCCCGTCTCTGGATGTG -> ACCCCGTCTCTGGATGTGC
CACCCCTGAATCCATCTGT -> ACCCCTGAATCCATCTGTC
CACCCGCGTAGGAGCGTCA -> ACCCGCGTAGGAGCGTCAC
CACCGAGCTTTCACGGAGA -> ACCGAGCTTTCACGGAGAT
CACCGCCGTCACCGCCTCC -> ACCGCCGTCACCGCCTCCT
CACCGCCTCCTTTGTCTGA -> ACCGCCTCCTTTGTCTGAC
CACCGTCTCCCTAACTCCG -> ACCGTCTCCCTAACTCCGC
CACCTATCCTCGGAAACTA -> ACCTATCCTCGGAAACTAG
CACGAAGGGGACCACAAGT -> ACGAAGGGGACCACAAGTT
CACGAATGGTAAAGTACAC -> ACGAATGGTAAAGTACACA
CACGACGCCTATGCGAAGC -> ACGACGCCTATGCGAAGCT
CACGACTAGGTGCCTCAGC -> ACGACTAGGTGCCTCAGCA
CACGGAGATGCCAGACACG -> ACGGAGATGCCAGACACGT
CACGGTAACAAATAACAGC -> ACGGTAACAAATAACAGCG
CACGGTGTACAGCTCAACG -> ACGGTGTACAGCTCAACGC
CACGTCTTATGTTTAACTC -> ACGTCTTATGTTTAACTCA
CACTACTCACAAGATTACA -> ACTACTCACAAGATTACAC
CACTGACTCGATCTGTATG -> ACTGACTCGATCTGTATGG
CACTGATGCACTTTCGCCG -> ACTGATGCACTTTCGCCGT
CACTGCAGAGTGATCGTTA -> ACTGCAGAGTGATCGTTAA
CACTGTATGTCATTCGATG -> ACTGTATGTCATTCGATGT
CACTTACTGGTTCGCGCTG -> ACTTACTGGTTCGCGCTGC
CACTTCCCACGGTAACAAA -> ACTTCCCACGGTAACAAAT
CACTTGCTCAACGCAAACC -> ACTTGCTCAACGCAAACCA
CACTTTCGCCGTTGTATGC -> ACTTTCGCCGTTGTATGCA
CAGACACGAATGGTAAAGT -> AGACACGAATGGTAAAGTA
CAGACACGTCTTATGTTTA -> AGACACGTCTTATGTTTAA
CAGACTAAACATATGAGGA -> AGACTAAACATATGAGGAG
CAGAGGACCCCAGACACGA -> AGAGGACCCCAGACACGAA
CAGAGTGATCGTTAATTCT -> AGAGTGATCGTTAATTCTT
CAGATTTTGCAAACATGGA -> AGATTTTGCAAACATGGAA
CAGCAACCGAACGTTGGGA -> AGCAACCGAACGTTGGGAG
CAGCACTTGCTCAACGCAA -> AGCACTTGCTCAACGCAAA
CAGCCGCGTACCCCTCTGT -> AGCCGCGTACCCCTCTGTT
CAGCCTAGGCATGCAGGAT -> AGCCTAGGCATGCAGGATG
CAGCCTCGTAGTAGGGATC -> AGCCTCGTAGTAGGGATCC
CAGCGCTCCACCTATCCTC -> AGCGCTCCACCTATCCTCG
CAGCGCTCTGTCAGTATCC -> AGCGCTCTGTCAGTATCCC
CAGCGGTCTATGTGCATTA -> AGCGGTCTATGTGCATTAC
CAGCGTGGCCTGCCTCTGA -> AGCGTGGCCTGCCTCTGAG
CAGCTCAACGCAAACCATT -> AGCTCAACGCAAACCATTA
CAGGACGATCGTCTTACGT -> AGGACGATCGTCTTACGTC
CAGGATGAAATTCTTGTTT -> AGGATGAAATTCTTGTTTC
CAGGCCCATGGCATAGCGC -> AGGCCCATGGCATAGCGCC
CAGGGACGGTATGCCTTGG -> AGGGACGGTATGCCTTGGG
CAGGGAGTCGGTTTACGAA -> AGGGAGTCGGTTTACGAAC
CAGTACGGGTTCTGGGTGG -> AGTACGGGTTCTGGGTGGA
CAGTAGGGATCCCCGCGGG -> AGTAGGGATCCCCGCGGGT
CAGTATCCCGCAATGGCCG -> AGTATCCCGCAATGGCCGC
CAGTGCGTCAAGGGGCGCC -> AGTGCGTCAAGGGGCGCCC
CAGTGGCACTGACTCGATC -> AGTGGCACTGACTCGATCT
CAGTTACCCCTTTGAATAG -> AGTTACCCCTTTGAATAGC
CAGTTAGAATAGACCGCCC -> AGTTAGAATAGACCGCCCA
CAGTTCAAGGATTTACTTC -> AGTTCAAGGATTTACTTCT
CATAACGGTACTGGGTGCA -> ATAACGGTACTGGGTGCAA
CATAAGGAATAATATCGAT -> ATAAGGAATAATATCGATT
CATAAGTCTAATTAGATTT -> ATAAGTCTAATTAGATTTC
CATACGGCTGAGTGGGGGG -> ATACGGCTGAGTGGGGGGA
CATAGACCGCTTCCTTGGG -> ATAGACCGCTTCCTTGGGC
CATAGCGCCTGATGCCTTC -> ATAGCGCCTGATGCCTTCG
CATATGAGGAGGGGCCCAT -> ATATGAGGAGGGGCCCATT
CATATTGCAAGTGTGTGGC -> ATATTGCAAGTGTGTGGCC
CATCAACGTTGACCCTTAA -> ATCAACGTTGACCCTTAAC
CATCATGGTAACCCGGGAT -> ATCATGGTAACCCGGGATT
CATCCTGATCAAGCGCGAA -> ATCCTGATCAAGCGCGAAT
CATCGATAACCAATGAGGC -> ATCGATAACCAATGAGGCA
CATCGCCCGTAAAACGAGG -> ATCGCCCGTAAAACGAGGT
CATCTGTCACCCGCGTAGG -> ATCTGTCACCCGCGTAGGA
CATCTTCTGAGTGAGTTAG -> ATCTTCTGAGTGAGTTAGC
CATGCAGGATGAAATTCTT -> ATGCAGGATGAAATTCTTG
CATGCCGACACCATCTTCT -> ATGCCGACACCATCTTCTG
CATGCCTTCGTTTCAGTTA -> ATGCCTTCGTTTCAGTTAG
CATGCTATAGGATACCTTG -> ATGCTATAGGATACCTTGG
CATGCTCGAGGTACAGATT -> ATGCTCGAGGTACAGATTT
CATGGAAACATCATGGTAA -> ATGGAAACATCATGGTAAC
CATGGAACGCACGACTAGG -> ATGGAACGCACGACTAGGT
CATGGCATAGCGCCTGATG -> ATGGCATAGCGCCTGATGC
CATGGGTGGTTGCTATTTG -> ATGGGTGGTTGCTATTTGG
CATGGTAACCCGGGATTAG -> ATGGTAACCCGGGATTAGC
CATTAAGCTATCCGACAGT -> ATTAAGCTATCCGACAGTA
CATTAATAAAGCGATGTGT -> ATTAATAAAGCGATGTGTA
CATTACACAGCCTCGTAGT -> ATTACACAGCCTCGTAGTA
CATTACCGCTTGTGACCCC -> ATTACCGCTTGTGACCCCG
CATTAGACGACGCTCAAGT -> ATTAGACGACGCTCAAGTA
CATTATCGGTGCTGTTAGT -> ATTATCGGTGCTGTTAGTA
CATTCGATGTGTAGCCGAA -> ATTCGATGTGTAGCCGAAA
CATTCGTTAGCCCGCACCC -> ATTCGTTAGCCCGCACCCC
CATTGAACATACGGCTGAG -> ATTGAACATACGGCTGAGT
CATTGTACGTGCACTGATG -> ATTGTACGTGCACTGATGC
CATTTATAATATGATCACC -> ATTTATAATATGATCACCG
CATTTCCATAAGTCTAATT -> ATTTCCATAAGTCTAATTA
CATTTGACTTAACGTCTAT -> ATTTGACTTAACGTCTATT
CATTTGGAGATGCTCATTA -> ATTTGGAGATGCTCATTAA
CATTTGTCAGTACGGGTTC -> ATTTGTCAGTACGGGTTCT
CATTTTACCTCCGGGGATT -> ATTTTACCTCCGGGGATTT
CCAAACTCCATTGTACGTG -> CAAACTCCATTGTACGTGC
CCAAAGATCAGCCGCGTAC -> CAAAGATCAGCCGCGTACC
CCAAAGTAGAGACAATGTA -> CAAAGTAGAGACAATGTAT
CCAACGAAGGCTACGTGGT -> CAACGAAGGCTACGTGGTG
CCAATGAGGCAGAGGACCC -> CAATGAGGCAGAGGACCCC
CCACAAGTTTGTACCGGGG -> CACAAGTTTGTACCGGGGA
CCACACGGTGTACAGCTCA -> CACACGGTGTACAGCTCAA
CCACCCCGTCTCTGGATGT -> CACCCCGTCTCTGGATGTG
CCACCGCCGTCACCGCCTC -> CACCGCCGTCACCGCCTCC
CCACCGTCTCCCTAACTCC -> CACCGTCTCCCTAACTCCG
CCACCTATCCTCGGAAACT -> CACCTATCCTCGGAAACTA
CCACGGTAACAAATAACAG -> CACGGTAACAAATAACAGC
CCACTACTCACAAGATTAC -> CACTACTCACAAGATTACA
CCACTGTATGTCATTCGAT -> CACTGTATGTCATTCGATG
CCAGACACGAATGGTAAAG -> CAGACACGAATGGTAAAGT
CCAGACACGTCTTATGTTT -> CAGACACGTCTTATGTTTA
CCAGGACGATCGTCTTACG -> CAGGACGATCGTCTTACGT
CCAGGCCCATGGCATAGCG -> CAGGCCCATGGCATAGCGC
CCAGTGGCACTGACTCGAT -> CAGTGGCACTGACTCGATC
CCAGTTCAAGGATTTACTT -> CAGTTCAAGGATTTACTTC
CCATAAGGAATAATATCGA -> CATAAGGAATAATATCGAT
CCATAAGTCTAATTAGATT -> CATAAGTCTAATTAGATTT
CCATCCTGATCAAGCGCGA -> CATCCTGATCAAGCGCGAA
CCATCGCCCGTAAAACGAG -> CATCGCCCGTAAAACGAGG
CCATCTGTCACCCGCGTAG -> CATCTGTCACCCGCGTAGG
CCATCTTCTGAGTGAGTTA -> CATCTTCTGAGTGAGTTAG
CCATGCCTTCGTTTCAGTT -> CATGCCTTCGTTTCAGTTA
CCATGCTCGAGGTACAGAT -> CATGCTCGAGGTACAGATT
CCATGGCATAGCGCCTGAT -> CATGGCATAGCGCCTGATG
CCATTAAGCTATCCGACAG -> CATTAAGCTATCCGACAGT
CCATTACACAGCCTCGTAG -> CATTACACAGCCTCGTAGT
CCATTAGACGACGCTCAAG -> CATTAGACGACGCTCAAGT
CCATTATCGGTGCTGTTAG -> CATTATCGGTGCTGTTAGT
CCATTGAACATACGGCTGA -> CATTGAACATACGGCTGAG
CCATTGTACGTGCACTGAT -> CATTGTACGTGCACTGATG
CCATTTGGAGATGCTCATT -> CATTTGGAGATGCTCATTA
CCCACACGGTGTACAGCTC -> CCACACGGTGTACAGCTCA
CCCACCCCGTCTCTGGATG -> CCACCCCGTCTCTGGATGT
CCCACGGTAACAAATAACA -> CCACGGTAACAAATAACAG
CCCACTACTCACAAGATTA -> CCACTACTCACAAGATTAC
CCCAGACACGAATGGTAAA -> CCAGACACGAATGGTAAAG
CCCAGGACGATCGTCTTAC -> CCAGGACGATCGTCTTACG
CCCAGTGGCACTGACTCGA -> CCAGTGGCACTGACTCGAT
CCCAGTTCAAGGATTTACT -> CCAGTTCAAGGATTTACTT
CCCATCCTGATCAAGCGCG -> CCATCCTGATCAAGCGCGA
CCCATCGCCCGTAAAACGA -> CCATCGCCCGTAAAACGAG
CCCATGGCATAGCGCCTGA -> CCATGGCATAGCGCCTGAT
CCCATTGAACATACGGCTG -> CCATTGAACATACGGCTGA
CCCCACACGGTGTACAGCT -> CCCACACGGTGTACAGCTC
CCCCAGACACGAATGGTAA -> CCCAGACACGAATGGTAAA
CCCCCCTTCAGACTAAACA -> CCCCCTTCAGACTAAACAT
CCCCCTTCAGACTAAACAT -> CCCCTTCAGACTAAACATA
CCCCGCAGTGCGTCAAGGG -> CCCGCAGTGCGTCAAGGGG
CCCCGCGGGTATGTTGTTA -> CCCGCGGGTATGTTGTTAC
CCCCGCGGGTCTGACTGCA -> CCCGCGGGTCTGACTGCAC
CCCCGCGGGTTCCCGCATG -> CCCGCGGGTTCCCGCATGC
CCCCGCGGGTTTACGGAGG -> CCCGCGGGTTTACGGAGGA
CCCCGTCTCTGGATGTGCT -> CCCGTCTCTGGATGTGCTA
CCCCGTTATAAGATTCCGA -> CCCGTTATAAGATTCCGAA
CCCCTCTGTTATGTCTCAG -> CCCTCTGTTATGTCTCAGC
CCCCTGAATCCATCTGTCA -> CCCTGAATCCATCTGTCAC
CCCCTTCAGACTAAACATA -> CCCTTCAGACTAAACATAT
CCCCTTTGAATAGCCTCCT -> CCCTTTGAATAGCCTCCTG
CCCGACGGTGTATTGCCAC -> CCGACGGTGTATTGCCACT
CCCGCAATGGCCGCTTACC -> CCGCAATGGCCGCTTACCA
CCCGCACCCCTGAATCCAT -> CCGCACCCCTGAATCCATC
CCCGCAGTGCGTCAAGGGG -> CCGCAGTGCGTCAAGGGGC
CCCGCATGCCGACACCATC -> CCGCATGCCGACACCATCT
CCCGCCGTGCACGAAGGGG -> CCGCCGTGCACGAAGGGGA
CCCGCGGGTATGTTGTTAC -> CCGCGGGTATGTTGTTACC
CCCGCGGGTCTGACTGCAC -> CCGCGGGTCTGACTGCACG
CCCGCGGGTTCCCGCATGC -> CCGCGGGTTCCCGCATGCC
CCCGCGGGTTTACGGAGGA -> CCGCGGGTTTACGGAGGAC
CCCGCGTAGGAGCGTCACT -> CCGCGTAGGAGCGTCACTG
CCCGGGATTAGCTTCTCCG -> CCGGGATTAGCTTCTCCGT
CCCGTAAAACGAGGTGTAT -> CCGTAAAACGAGGTGTATC
CCCGTCTCTGGATGTGCTA -> CCGTCTCTGGATGTGCTAA
CCCGTGACTTCAGGGACGG -> CCGTGACTTCAGGGACGGT
CCCGTTATAAGATTCCGAA -> CCGTTATAAGATTCCGAAA
CCCGTTTGTCTATCATTTG -> CCGTTTGTCTATCATTTGT
CCCTAACTCCGCCCATCCT -> CCTAACTCCGCCCATCCTG
CCCTAGGAATATCAGCGCT -> CCTAGGAATATCAGCGCTC
CCCTCCCGTGACTTCAGGG -> CCTCCCGTGACTTCAGGGA
CCCTCTGTTATGTCTCAGC -> CCTCTGTTATGTCTCAGCG
CCCTGAATCCATCTGTCAC -> CCTGAATCCATCTGTCACC
CCCTGGTCTTTGCCCGTTT -> CCTGGTCTTTGCCCGTTTG
CCCTTAACCGTCGTACGAG -> CCTTAACCGTCGTACGAGC
CCCTTCAGACTAAACATAT -> CCTTCAGACTAAACATATG
CCCTTTGAATAGCCTCCTG -> CCTTTGAATAGCCTCCTGG
CCGAAAAGCCGGCCATTTG -> CGAAAAGCCGGCCATTTGG
CCGAAACAGCGCTCCACCT -> CGAAACAGCGCTCCACCTA
CCGAACGTTGGGAGGCGCG -> CGAACGTTGGGAGGCGCGT
CCGAAGCGCGCAAGGAGAC -> CGAAGCGCGCAAGGAGACC
CCGAATAGGGATGAAAGCA -> CGAATAGGGATGAAAGCAT
CCGACACCATCTTCTGAGT -> CGACACCATCTTCTGAGTG
CCGACAGTAGGGATCCCCG -> CGACAGTAGGGATCCCCGC
CCGACGGTGTATTGCCACT -> CGACGGTGTATTGCCACTG
CCGAGCTTTCACGGAGATG -> CGAGCTTTCACGGAGATGC
CCGCAATGGCCGCTTACCA -> CGCAATGGCCGCTTACCAC
CCGCACCCCTGAATCCATC -> CGCACCCCTGAATCCATCT
CCGCAGTGCGTCAAGGGGC -> CGCAGTGCGTCAAGGGGCG
CCGCATGCCGACACCATCT -> CGCATGCCGACACCATCTT
CCGCCCAGGCCGCGGCCTC -> CGCCCAGGCCGCGGCCTCG
CCGCCCATCCTGATCAAGC -> CGCCCATCCTGATCAAGCG
CCGCCGTCACCGCCTCCTT -> CGCCGTCACCGCCTCCTTT
CCGCCGTGCACGAAGGGGA -> CGCCGTGCACGAAGGGGAC
CCGCCTCCTTTGTCTGACT -> CGCCTCCTTTGTCTGACTG
CCGCGGGTATGTTGTTACC -> CGCGGGTATGTTGTTACCC
CCGCGGGTCTGACTGCACG -> CGCGGGTCTGACTGCACGA
CCGCGGGTTCCCGCATGCC -> CGCGGGTTCCCGCATGCCG
CCGCGGGTTTACGGAGGAC -> CGCGGGTTTACGGAGGACG
CCGCGTACCCCTCTGTTAT -> CGCGTACCCCTCTGTTATG
CCGCGTAGGAGCGTCACTG -> CGCGTAGGAGCGTCACTGC
CCGCTTACCACCGCCGTCA -> CGCTTACCACCGCCGTCAC
CCGCTTCCTTGGGCTGAAA -> CGCTTCCTTGGGCTGAAAT
CCGCTTGTGACCCCGCAGT -> CGCTTGTGACCCCGCAGTG
CCGGCCATTTGGAGATGCT -> CGGCCATTTGGAGATGCTC
CCGGGATTAGCTTCTCCGT -> CGGGATTAGCTTCTCCGTT
CCGGGGAGGCTCGGGGCCA -> CGGGGAGGCTCGGGGCCAA
CCGGGGATTTCAATTAGCT -> CGGGGATTTCAATTAGCTA
CCGTAAAACGAGGTGTATC -> CGTAAAACGAGGTGTATCA
CCGTCACCGCCTCCTTTGT -> CGTCACCGCCTCCTTTGTC
CCGTCGCGACAAATAGTGC -> CGTCGCGACAAATAGTGCG
CCGTCGTACGAGCGCCCTA -> CGTCGTACGAGCGCCCTAG
CCGTCTCCCTAACTCCGCC -> CGTCTCCCTAACTCCGCCC
CCGTCTCTGGATGTGCTAA -> CGTCTCTGGATGTGCTAAC
CCGTCTTATTGATATGGCC -> CGTCTTATTGATATGGCCC
CCGTGACTTCAGGGACGGT -> CGTGACTTCAGGGACGGTA
CCGTGCACGAAGGGGACCA -> CGTGCACGAAGGGGACCAC
CCGTTATAAGATTCCGAAA -> CGTTATAAGATTCCGAAAA
CCGTTGTATGCATGGAAAC -> CGTTGTATGCATGGAAACA
CCGTTTGTCTATCATTTGT -> CGTTTGTCTATCATTTGTC
CCGTTTTCATTCGTTAGCC -> CGTTTTCATTCGTTAGCCC
CCTAACTCCGCCCATCCTG -> CTAACTCCGCCCATCCTGA
CCTACATGCTATAGGATAC -> CTACATGCTATAGGATACC
CCTAGGAATATCAGCGCTC -> CTAGGAATATCAGCGCTCT
CCTAGGCATGCAGGATGAA -> CTAGGCATGCAGGATGAAA
CCTATATTCGTATCGAACA -> CTATATTCGTATCGAACAC
CCTATCCCAGTGGCACTGA -> CTATCCCAGTGGCACTGAC
CCTATCCTCGGAAACTAGT -> CTATCCTCGGAAACTAGTA
CCTATGCGAAGCTCGCTAC -> CTATGCGAAGCTCGCTACT
CCTCAGCAACCGAACGTTG -> CTCAGCAACCGAACGTTGG
CCTCCCGTGACTTCAGGGA -> CTCCCGTGACTTCAGGGAC
CCTCCGGGGATTTCAATTA -> CTCCGGGGATTTCAATTAG
CCTCCTGGTCGTAAACCTG -> CTCCTGGTCGTAAACCTGT
CCTCCTTTGTCTGACTGAA -> CTCCTTTGTCTGACTGAAT
CCTCGGAAACTAGTACGAC -> CTCGGAAACTAGTACGACG
CCTCGTAGTAGGGATCCCC -> CTCGTAGTAGGGATCCCCG
CCTCTGAGTACTTCATGGG -> CTCTGAGTACTTCATGGGT
CCTCTGTTATGTCTCAGCG -> CTCTGTTATGTCTCAGCGG
CCTGAATCCATCTGTCACC -> CTGAATCCATCTGTCACCC
CCTGATCAAGCGCGAATGC -> CTGATCAAGCGCGAATGCA
CCTGATGCCTTCGAGGAGG -> CTGATGCCTTCGAGGAGGC
CCTGCCTCTGAGTACTTCA -> CTGCCTCTGAGTACTTCAT
CCTGGTCGTAAACCTGTCT -> CTGGTCGTAAACCTGTCTC
CCTGGTCTTTGCCCGTTTG -> CTGGTCTTTGCCCGTTTGT
CCTGTCTCCAAACTCCATT -> CTGTCTCCAAACTCCATTG
CCTTAACCGTCGTACGAGC -> CTTAACCGTCGTACGAGCG
CCTTCAGACTAAACATATG -> CTTCAGACTAAACATATGA
CCTTCGAGGAGGCCCGACG -> CTTCGAGGAGGCCCGACGG
CCTTCGTAGAATTGCGGTA -> CTTCGTAGAATTGCGGTAT
CCTTCGTTTCAGTTAGAAT -> CTTCGTTTCAGTTAGAATA
CCTTCTCACAAGGCTGATT -> CTTCTCACAAGGCTGATTC
CCTTGGGCTGAAATCCTAT -> CTTGGGCTGAAATCCTATC
CCTTGGGGAATCGGCTCAA -> CTTGGGGAATCGGCTCAAC
CCTTGGTATACCCCGTTAT -> CTTGGTATACCCCGTTATA
CCTTTCCGTCGCGACAAAT -> CTTTCCGTCGCGACAAATA
CCTTTGAATAGCCTCCTGG -> CTTTGAATAGCCTCCTGGT
CCTTTGTCTGACTGAATCC -> CTTTGTCTGACTGAATCCA
CGAAAAGCCGGCCATTTGG -> GAAAAGCCGGCCATTTGGA
CGAAACAGCGCTCCACCTA -> GAAACAGCGCTCCACCTAT
CGAACACAATCTTTTCCTT -> GAACACAATCTTTTCCTTT
CGAACAGGGAGTCGGTTTA -> GAACAGGGAGTCGGTTTAC
CGAACCACCGTCTCCCTAA -> GAACCACCGTCTCCCTAAC
CGAACGCCGAAGCGCGCAA -> GAACGCCGAAGCGCGCAAG
CGAACGTTGGGAGGCGCGT -> GAACGTTGGGAGGCGCGTT
CGAAGCGCGCAAGGAGACC -> GAAGCGCGCAAGGAGACCT
CGAAGCTCGCTACTATCGA -> GAAGCTCGCTACTATCGAA
CGAAGGCTACGTGGTGCCT -> GAAGGCTACGTGGTGCCTA
CGAAGGGGACCACAAGTTT -> GAAGGGGACCACAAGTTTG
CGAATAGGGATGAAAGCAT -> GAATAGGGATGAAAGCATT
CGAATGCAAGTCTGGCTCA -> GAATGCAAGTCTGGCTCAC
CGAATGGTAAAGTACACAA -> GAATGGTAAAGTACACAAG
CGACAAATAGTGCGCTCAA -> GACAAATAGTGCGCTCAAC
CGACACCATCTTCTGAGTG -> GACACCATCTTCTGAGTGA
CGACAGCCTAGGCATGCAG -> GACAGCCTAGGCATGCAGG
CGACAGTAGGGATCCCCGC -> GACAGTAGGGATCCCCGCG
CGACGCCTATGCGAAGCTC -> GACGCCTATGCGAAGCTCG
CGACGCTCAAGTAGGGATC -> GACGCTCAAGTAGGGATCC
CGACGGACCATAAGGAATA -> GACGGACCATAAGGAATAA
CGACGGTGTATTGCCACTG -> GACGGTGTATTGCCACTGT
CGACTAGGTGCCTCAGCAA -> GACTAGGTGCCTCAGCAAC
CGAGCGCCCTAGGAATATC -> GAGCGCCCTAGGAATATCA
CGAGCTTTCACGGAGATGC -> GAGCTTTCACGGAGATGCC
CGAGGAGGCCCGACGGTGT -> GAGGAGGCCCGACGGTGTA
CGAGGTACAGATTTTGCAA -> GAGGTACAGATTTTGCAAA
CGAGGTGTATCATAGACCG -> GAGGTGTATCATAGACCGC
CGATAACCAATGAGGCAGA -> GATAACCAATGAGGCAGAG
CGATACCATGCCTTCGTTT -> GATACCATGCCTTCGTTTC
CGATCGTCTTACGTCAACT -> GATCGTCTTACGTCAACTA
CGATCTGTATGGGACCATG -> GATCTGTATGGGACCATGC
CGATGTGTACTCTTCGGAC -> GATGTGTACTCTTCGGACG
CGATGTGTAGCCGAAACAG -> GATGTGTAGCCGAAACAGC
CGATTCCCACCCCGTCTCT -> GATTCCCACCCCGTCTCTG
CGCAAACCATTAAGCTATC -> GCAAACCATTAAGCTATCC
CGCAAACCATTACACAGCC -> GCAAACCATTACACAGCCT
CGCAAACCATTAGACGACG -> GCAAACCATTAGACGACGC
CGCAAACCATTATCGGTGC -> GCAAACCATTATCGGTGCT
CGCAAGGAGACCTTCGTAG -> GCAAGGAGACCTTCGTAGA
CGCAATGGCCGCTTACCAC -> GCAATGGCCGCTTACCACC
CGCACCCCTGAATCCATCT -> GCACCCCTGAATCCATCTG
CGCACGACTAGGTGCCTCA -> GCACGACTAGGTGCCTCAG
CGCAGTGCGTCAAGGGGCG -> GCAGTGCGTCAAGGGGCGC
CGCATGCCGACACCATCTT -> GCATGCCGACACCATCTTC
CGCCCAGGCCGCGGCCTCG -> GCCCAGGCCGCGGCCTCGG
CGCCCATCCTGATCAAGCG -> GCCCATCCTGATCAAGCGC
CGCCCCACACGGTGTACAG -> GCCCCACACGGTGTACAGC
CGCCCGTAAAACGAGGTGT -> GCCCGTAAAACGAGGTGTA
CGCCCTAGGAATATCAGCG -> GCCCTAGGAATATCAGCGC
CGCCGAAGCGCGCAAGGAG -> GCCGAAGCGCGCAAGGAGA
CGCCGTCACCGCCTCCTTT -> GCCGTCACCGCCTCCTTTG
CGCCGTGCACGAAGGGGAC -> GCCGTGCACGAAGGGGACC
CGCCGTTGTATGCATGGAA -> GCCGTTGTATGCATGGAAA
CGCCTATGCGAAGCTCGCT -> GCCTATGCGAAGCTCGCTA
CGCCTCCTTTGTCTGACTG -> GCCTCCTTTGTCTGACTGA
CGCCTGATGCCTTCGAGGA -> GCCTGATGCCTTCGAGGAG
CGCGAATGCAAGTCTGGCT -> GCGAATGCAAGTCTGGCTC
CGCGACAAATAGTGCGCTC -> GCGACAAATAGTGCGCTCA
CGCGCAAGGAGACCTTCGT -> GCGCAAGGAGACCTTCGTA
CGCGCTGCCGTCTTATTGA -> GCGCTGCCGTCTTATTGAT
CGCGGGTATGTTGTTACCC -> GCGGGTATGTTGTTACCCG
CGCGGGTCTGACTGCACGA -> GCGGGTCTGACTGCACGAC
CGCGGGTTCCCGCATGCCG -> GCGGGTTCCCGCATGCCGA
CGCGGGTTTACGGAGGACG -> GCGGGTTTACGGAGGACGG
CGCGTACCCCTCTGTTATG -> GCGTACCCCTCTGTTATGT
CGCGTAGGAGCGTCACTGC -> GCGTAGGAGCGTCACTGCA
CGCGTTTATGGATCTCATT -> GCGTTTATGGATCTCATTT
CGCTACTATCGAACAGGGA -> GCTACTATCGAACAGGGAG
CGCTCAACGCAAACCATTA -> GCTCAACGCAAACCATTAC
CGCTCAAGTAGGGATCCCC -> GCTCAAGTAGGGATCCCCG
CGCTCCACCTATCCTCGGA -> GCTCCACCTATCCTCGGAA
CGCTCTGTCAGTATCCCGC -> GCTCTGTCAGTATCCCGCA
CGCTGCCGTCTTATTGATA -> GCTGCCGTCTTATTGATAT
CGCTTACCACCGCCGTCAC -> GCTTACCACCGCCGTCACC
CGCTTCCTTGGGCTGAAAT -> GCTTCCTTGGGCTGAAATC
CGCTTGTGACCCCGCAGTG -> GCTTGTGACCCCGCAGTGC
CGGAAACTAGTACGACGGA -> GGAAACTAGTACGACGGAC
CGGACCATAAGGAATAATA -> GGACCATAAGGAATAATAT
CGGACGATACCATGCCTTC -> GGACGATACCATGCCTTCG
CGGAGATGCCAGACACGTC -> GGAGATGCCAGACACGTCT
CGGAGGACGGTTCTTTTGA -> GGAGGACGGTTCTTTTGAA
CGGCCATTTGGAGATGCTC -> GGCCATTTGGAGATGCTCA
CGGCTCAACGCAAACCATT -> GGCTCAACGCAAACCATTA
CGGCTGAGTGGGGGGAGTT -> GGCTGAGTGGGGGGAGTTT
CGGGATTAGCTTCTCCGTT -> GGGATTAGCTTCTCCGTTT
CGGGGAGGCTCGGGGCCAA -> GGGGAGGCTCGGGGCCAAA
CGGGGATTTCAATTAGCTA -> GGGGATTTCAATTAGCTAA
CGGGGCCAAAGTAGAGACA -> GGGGCCAAAGTAGAGACAA
CGGGTATGTTGTTACCCGC -> GGGTATGTTGTTACCCGCC
CGGGTCTGACTGCACGACG -> GGGTCTGACTGCACGACGC
CGGGTTCCCGCATGCCGAC -> GGGTTCCCGCATGCCGACA
CGGGTTCTGGGTGGAGGCT -> GGGTTCTGGGTGGAGGCTA
CGGGTTTACGGAGGACGGT -> GGGTTTACGGAGGACGGTT
CGGTAACAAATAACAGCGT -> GGTAACAAATAACAGCGTG
CGGTACTGGGTGCAATCCA -> GGTACTGGGTGCAATCCAG
CGGTATGAGTTATGTTCTC -> GGTATGAGTTATGTTCTCC
CGGTATGCCTTGGGGAATC -> GGTATGCCTTGGGGAATCG
CGGTCTATGTGCATTACCG -> GGTCTATGTGCATTACCGC
CGGTGCTGTTAGTAGGGAT -> GGTGCTGTTAGTAGGGATC
CGGTGTACAGCTCAACGCA -> GGTGTACAGCTCAACGCAA
CGGTGTATTGCCACTGTAT -> GGTGTATTGCCACTGTATG
CGGTTCTTTTGAATATCTA -> GGTTCTTTTGAATATCTAG
CGGTTTACGAACCACCGTC -> GGTTTACGAACCACCGTCT
CGTAAAACGAGGTGTATCA -> GTAAAACGAGGTGTATCAT
CGTAAACCTGTCTCCAAAC -> GTAAACCTGTCTCCAAACT
CGTACCCCTCTGTTATGTC -> GTACCCCTCTGTTATGTCT
CGTACGAGCGCCCTAGGAA -> GTACGAGCGCCCTAGGAAT
CGTAGAATTGCGGTATGAG -> GTAGAATTGCGGTATGAGT
CGTAGGAGCGTCACTGCAG -> GTAGGAGCGTCACTGCAGA
CGTAGTAGGGATCCCCGCG -> GTAGTAGGGATCCCCGCGG
CGTATCGAACACAATCTTT -> GTATCGAACACAATCTTTT
CGTCAACTACATTTTACCT -> GTCAACTACATTTTACCTC
CGTCAAGGGGCGCCCCACA -> GTCAAGGGGCGCCCCACAC
CGTCACCGCCTCCTTTGTC -> GTCACCGCCTCCTTTGTCT
CGTCACTGCAGAGTGATCG -> GTCACTGCAGAGTGATCGT
CGTCGCGACAAATAGTGCG -> GTCGCGACAAATAGTGCGC
CGTCGTACGAGCGCCCTAG -> GTCGTACGAGCGCCCTAGG
CGTCTATTCATAACGGTAC -> GTCTATTCATAACGGTACT
CGTCTCCCTAACTCCGCCC -> GTCTCCCTAACTCCGCCCA
CGTCTCTGGATGTGCTAAC -> GTCTCTGGATGTGCTAACA
CGTCTTACGTCAACTACAT -> GTCTTACGTCAACTACATT
CGTCTTATGTTTAACTCAC -> GTCTTATGTTTAACTCACA
CGTCTTATTGATATGGCCC -> GTCTTATTGATATGGCCCT
CGTGACTTCAGGGACGGTA -> GTGACTTCAGGGACGGTAT
CGTGCACGAAGGGGACCAC -> GTGCACGAAGGGGACCACA
CGTGCACTGATGCACTTTC -> GTGCACTGATGCACTTTCG
CGTGCGAACGCCGAAGCGC -> GTGCGAACGCCGAAGCGCG
CGTGGCCTGCCTCTGAGTA -> GTGGCCTGCCTCTGAGTAC
CGTGGTGCCTATATTCGTA -> GTGGTGCCTATATTCGTAT
CGTTAATTCTTCCCATCGC -> GTTAATTCTTCCCATCGCC
CGTTAGCCCGCACCCCTGA -> GTTAGCCCGCACCCCTGAA
CGTTATAAGATTCCGAAAA -> GTTATAAGATTCCGAAAAG
CGTTGACCCTTAACCGTCG -> GTTGACCCTTAACCGTCGT
CGTTGGGAGGCGCGTTTAT -> GTTGGGAGGCGCGTTTATG
CGTTGTATGCATGGAAACA -> GTTGTATGCATGGAAACAT
CGTTTATGGATCTCATTTC -> GTTTATGGATCTCATTTCC
CGTTTCAGTTAGAATAGAC -> GTTTCAGTTAGAATAGACC
CGTTTGTCTATCATTTGTC -> GTTTGTCTATCATTTGTCA
CGTTTTCATTCGTTAGCCC -> GTTTTCATTCGTTAGCCCG
CTAAACATATGAGGAGGGG -> TAAACATATGAGGAGGGGC
CTAAATAGCAACCCCCCTT -> TAAATAGCAACCCCCCTTC
CTAACAAAGACTAGCAACA -> TAACAAAGACTAGCAACAC
CTAACCTACATGCTATAGG -> TAACCTACATGCTATAGGA
CTAACTCCGCCCATCCTGA -> TAACTCCGCCCATCCTGAT
CTAAGCCTTCTCACAAGGC -> TAAGCCTTCTCACAAGGCT
CTAAGCTAACCTACATGCT -> TAAGCTAACCTACATGCTA
CTAATTAGATTTCTTACCC -> TAATTAGATTTCTTACCCA
CTACATCGATAACCAATGA -> TACATCGATAACCAATGAG
CTACATGCTATAGGATACC -> TACATGCTATAGGATACCT
CTACATTTTACCTCCGGGG -> TACATTTTACCTCCGGGGA
CTACGTGGTGCCTATATTC -> TACGTGGTGCCTATATTCG
CTACTATCGAACAGGGAGT -> TACTATCGAACAGGGAGTC
CTACTCACAAGATTACACC -> TACTCACAAGATTACACCA
CTAGCAACACTTACTGGTT -> TAGCAACACTTACTGGTTC
CTAGGAATATCAGCGCTCT -> TAGGAATATCAGCGCTCTG
CTAGGCATGCAGGATGAAA -> TAGGCATGCAGGATGAAAT
CTAGGTGCCTCAGCAACCG -> TAGGTGCCTCAGCAACCGA
CTAGTACGACGGACCATAA -> TAGTACGACGGACCATAAG
CTAGTGTCCCTGGTCTTTG -> TAGTGTCCCTGGTCTTTGC
CTATAGGATACCTTGGTAT -> TATAGGATACCTTGGTATA
CTATATTCGTATCGAACAC -> TATATTCGTATCGAACACA
CTATCATTTGTCAGTACGG -> TATCATTTGTCAGTACGGG
CTATCCCAGTGGCACTGAC -> TATCCCAGTGGCACTGACT
CTATCCGACAGTAGGGATC -> TATCCGACAGTAGGGATCC
CTATCCTCGGAAACTAGTA -> TATCCTCGGAAACTAGTAC
CTATCGAACAGGGAGTCGG -> TATCGAACAGGGAGTCGGT
CTATGCGAAGCTCGCTACT -> TATGCGAAGCTCGCTACTA
CTATGTGCATTACCGCTTG -> TATGTGCATTACCGCTTGT
CTATTCATAACGGTACTGG -> TATTCATAACGGTACTGGG
CTATTTGGCTACATCGATA -> TATTTGGCTACATCGATAA
CTCAACGCAAACCATTAAG -> TCAACGCAAACCATTAAGC
CTCAACGCAAACCATTACA -> TCAACGCAAACCATTACAC
CTCAACGCAAACCATTAGA -> TCAACGCAAACCATTAGAC
CTCAACGCAAACCATTATC -> TCAACGCAAACCATTATCG
CTCAAGTAGGGATCCCCGC -> TCAAGTAGGGATCCCCGCG
CTCACAAGATTACACCAAA -> TCACAAGATTACACCAAAG
CTCACAAGGCTGATTCAGC -> TCACAAGGCTGATTCAGCA
CTCACATCAACGTTGACCC -> TCACATCAACGTTGACCCT
CTCACTTCCCACGGTAACA -> TCACTTCCCACGGTAACAA
CTCAGCAACCGAACGTTGG -> TCAGCAACCGAACGTTGGG
CTCAGCGGTCTATGTGCAT -> TCAGCGGTCTATGTGCATT
CTCATTAATAAAGCGATGT -> TCATTAATAAAGCGATGTG
CTCATTTCCATAAGTCTAA -> TCATTTCCATAAGTCTAAT
CTCCAAACTCCATTGTACG -> TCCAAACTCCATTGTACGT
CTCCACCTATCCTCGGAAA -> TCCACCTATCCTCGGAAAC
CTCCATTGTACGTGCACTG -> TCCATTGTACGTGCACTGA
CTCCCGTGACTTCAGGGAC -> TCCCGTGACTTCAGGGACG
CTCCCTAACTCCGCCCATC -> TCCCTAACTCCGCCCATCC
CTCCGAATAGGGATGAAAG -> TCCGAATAGGGATGAAAGC
CTCCGCCCATCCTGATCAA -> TCCGCCCATCCTGATCAAG
CTCCGGGGATTTCAATTAG -> TCCGGGGATTTCAATTAGC
CTCCGTTTTCATTCGTTAG -> TCCGTTTTCATTCGTTAGC
CTCCTGGTCGTAAACCTGT -> TCCTGGTCGTAAACCTGTC
CTCCTTTGTCTGACTGAAT -> TCCTTTGTCTGACTGAATC
CTCGAGGTACAGATTTTGC -> TCGAGGTACAGATTTTGCA
CTCGATCTGTATGGGACCA -> TCGATCTGTATGGGACCAT
CTCGCTACTATCGAACAGG -> TCGCTACTATCGAACAGGG
CTCGGAAACTAGTACGACG -> TCGGAAACTAGTACGACGG
CTCGGGGCCAAAGTAGAGA -> TCGGGGCCAAAGTAGAGAC
CTCGTAGTAGGGATCCCCG -> TCGTAGTAGGGATCCCCGC
CTCTGAGTACTTCATGGGT -> TCTGAGTACTTCATGGGTG
CTCTGGATGTGCTAACAAA -> TCTGGATGTGCTAACAAAG
CTCTGTCAGTATCCCGCAA -> TCTGTCAGTATCCCGCAAT
CTCTGTTATGTCTCAGCGG -> TCTGTTATGTCTCAGCGGT
CTCTTCGGACGATACCATG -> TCTTCGGACGATACCATGC
CTGAAATCCTATCCCAGTG -> TGAAATCCTATCCCAGTGG
CTGAATCCAACGAAGGCTA -> TGAATCCAACGAAGGCTAC
CTGAATCCATCTGTCACCC -> TGAATCCATCTGTCACCCG
CTGACTCGATCTGTATGGG -> TGACTCGATCTGTATGGGA
CTGACTGAATCCAACGAAG -> TGACTGAATCCAACGAAGG
CTGACTGCACGACGCCTAT -> TGACTGCACGACGCCTATG
CTGAGTACTTCATGGGTGG -> TGAGTACTTCATGGGTGGT
CTGAGTGAGTTAGCAGTTA -> TGAGTGAGTTAGCAGTTAC
CTGAGTGGGGGGAGTTTAT -> TGAGTGGGGGGAGTTTATA
CTGATCAAGCGCGAATGCA -> TGATCAAGCGCGAATGCAA
CTGATGCACTTTCGCCGTT -> TGATGCACTTTCGCCGTTG
CTGATGCCTTCGAGGAGGC -> TGATGCCTTCGAGGAGGCC
CTGATTCAGCACTTGCTCA -> TGATTCAGCACTTGCTCAA
CTGCACGACGCCTATGCGA -> TGCACGACGCCTATGCGAA
CTGCAGAGTGATCGTTAAT -> TGCAGAGTGATCGTTAATT
CTGCCGTCTTATTGATATG -> TGCCGTCTTATTGATATGG
CTGCCTCTGAGTACTTCAT -> TGCCTCTGAGTACTTCATG
CTGGATGTGCTAACAAAGA -> TGGATGTGCTAACAAAGAC
CTGGCTCACTTCCCACGGT -> TGGCTCACTTCCCACGGTA
CTGGGTGCAATCCAGGCCC -> TGGGTGCAATCCAGGCCCA
CTGGGTGGAGGCTAAATAG -> TGGGTGGAGGCTAAATAGC
CTGGTCGTAAACCTGTCTC -> TGGTCGTAAACCTGTCTCC
CTGGTCTTTGCCCGTTTGT -> TGGTCTTTGCCCGTTTGTC
CTGGTTCGCGCTGCCGTCT -> TGGTTCGCGCTGCCGTCTT
CTGTATGGGACCATGCTCG -> TGTATGGGACCATGCTCGA
CTGTATGTCATTCGATGTG -> TGTATGTCATTCGATGTGT
CTGTCACCCGCGTAGGAGC -> TGTCACCCGCGTAGGAGCG
CTGTCAGTATCCCGCAATG -> TGTCAGTATCCCGCAATGG
CTGTCTCCAAACTCCATTG -> TGTCTCCAAACTCCATTGT
CTGTTAGTAGGGATCCCCG -> TGTTAGTAGGGATCCCCGC
CTGTTATGTCTCAGCGGTC -> TGTTATGTCTCAGCGGTCT
CTTAACCGTCGTACGAGCG -> TTAACCGTCGTACGAGCGC
CTTAACGTCTATTCATAAC -> TTAACGTCTATTCATAACG
CTTAAGCGTGCGAACGCCG -> TTAAGCGTGCGAACGCCGA
CTTACCACCGCCGTCACCG -> TTACCACCGCCGTCACCGC
CTTACCCAGGACGATCGTC -> TTACCCAGGACGATCGTCT
CTTACGTCAACTACATTTT -> TTACGTCAACTACATTTTA
CTTACTGGTTCGCGCTGCC -> TTACTGGTTCGCGCTGCCG
CTTATGTTTAACTCACATC -> TTATGTTTAACTCACATCA
CTTATTGATATGGCCCTCC -> TTATTGATATGGCCCTCCC
CTTCAGACTAAACATATGA -> TTCAGACTAAACATATGAG
CTTCAGGGACGGTATGCCT -> TTCAGGGACGGTATGCCTT
CTTCATGGGTGGTTGCTAT -> TTCATGGGTGGTTGCTATT
CTTCCCACGGTAACAAATA -> TTCCCACGGTAACAAATAA
CTTCCCATCGCCCGTAAAA -> TTCCCATCGCCCGTAAAAC
CTTCCTTGGGCTGAAATCC -> TTCCTTGGGCTGAAATCCT
CTTCGAGGAGGCCCGACGG -> TTCGAGGAGGCCCGACGGT
CTTCGGACGATACCATGCC -> TTCGGACGATACCATGCCT
CTTCGTAGAATTGCGGTAT -> TTCGTAGAATTGCGGTATG
CTTCGTTTCAGTTAGAATA -> TTCGTTTCAGTTAGAATAG
CTTCTAAGCTAACCTACAT -> TTCTAAGCTAACCTACATG
CTTCTCACAAGGCTGATTC -> TTCTCACAAGGCTGATTCA
CTTCTCCGTTTTCATTCGT -> TTCTCCGTTTTCATTCGTT
CTTCTGAGTGAGTTAGCAG -> TTCTGAGTGAGTTAGCAGT
CTTGCTCAACGCAAACCAT -> TTGCTCAACGCAAACCATT
CTTGGGCTGAAATCCTATC -> TTGGGCTGAAATCCTATCC
CTTGGGGAATCGGCTCAAC -> TTGGGGAATCGGCTCAACG
CTTGGTATACCCCGTTATA -> TTGGTATACCCCGTTATAA
CTTGTGACCCCGCAGTGCG -> TTGTGACCCCGCAGTGCGT
CTTGTTTCCCACTACTCAC -> TTGTTTCCCACTACTCACA
CTTTCACGGAGATGCCAGA -> TTTCACGGAGATGCCAGAC
CTTTCCGTCGCGACAAATA -> TTTCCGTCGCGACAAATAG
CTTTCGCCGTTGTATGCAT -> TTTCGCCGTTGTATGCATG
CTTTGAATAGCCTCCTGGT -> TTTGAATAGCCTCCTGGTC
CTTTGCCCGTTTGTCTATC -> TTTGCCCGTTTGTCTATCA
CTTTGTCTGACTGAATCCA -> TTTGTCTGACTGAATCCAA
CTTTTCCTTTCCGTCGCGA -> TTTTCCTTTCCGTCGCGAC
CTTTTGAATATCTAGTGTC -> TTTTGAATATCTAGTGTCC
GAAAAGCCGGCCATTTGGA -> AAAAGCCGGCCATTTGGAG
GAAACAGCGCTCCACCTAT -> AAACAGCGCTCCACCTATC
GAAACATCATGGTAACCCG -> AAACATCATGGTAACCCGG
GAAACTAGTACGACGGACC -> AAACTAGTACGACGGACCA
GAAAGCATTTGACTTAACG -> AAAGCATTTGACTTAACGT
GAAATCCTATCCCAGTGGC -> AAATCCTATCCCAGTGGCA
GAAATTCTTGTTTCCCACT -> AAATTCTTGTTTCCCACTA
GAACACAATCTTTTCCTTT -> AACACAATCTTTTCCTTTC
GAACAGGGAGTCGGTTTAC -> AACAGGGAGTCGGTTTACG
GAACATACGGCTGAGTGGG -> AACATACGGCTGAGTGGGG
GAACCACCGTCTCCCTAAC -> AACCACCGTCTCCCTAACT
GAACGCACGACTAGGTGCC -> AACGCACGACTAGGTGCCT
GAACGCCGAAGCGCGCAAG -> AACGCCGAAGCGCGCAAGG
GAACGTTGGGAGGCGCGTT -> AACGTTGGGAGGCGCGTTT
GAAGCGCGCAAGGAGACCT -> AAGCGCGCAAGGAGACCTT
GAAGCTCGCTACTATCGAA -> AAGCTCGCTACTATCGAAC
GAAGGCTACGTGGTGCCTA -> AAGGCTACGTGGTGCCTAT
GAAGGGGACCACAAGTTTG -> AAGGGGACCACAAGTTTGT
GAATAATATCGATTCCCAC -> AATAATATCGATTCCCACC
GAATAGACCGCCCAGGCCG -> AATAGACCGCCCAGGCCGC
GAATAGCCTCCTGGTCGTA -> AATAGCCTCCTGGTCGTAA
GAATAGGGATGAAAGCATT -> AATAGGGATGAAAGCATTT
GAATATCAGCGCTCTGTCA -> AATATCAGCGCTCTGTCAG
GAATATCTAGTGTCCCTGG -> AATATCTAGTGTCCCTGGT
GAATCCAACGAAGGCTACG -> AATCCAACGAAGGCTACGT
GAATCCATCTGTCACCCGC -> AATCCATCTGTCACCCGCG
GAATCGGCTCAACGCAAAC -> AATCGGCTCAACGCAAACC
GAATGCAAGTCTGGCTCAC -> AATGCAAGTCTGGCTCACT
GAATGGTAAAGTACACAAG -> AATGGTAAAGTACACAAGT
GAATTGCGGTATGAGTTAT -> AATTGCGGTATGAGTTATG
GACAAATAGTGCGCTCAAC -> ACAAATAGTGCGCTCAACG
GACAATGTATGAGTGCATA -> ACAATGTATGAGTGCATAT
GACACCATCTTCTGAGTGA -> ACACCATCTTCTGAGTGAG
GACACGAATGGTAAAGTAC -> ACACGAATGGTAAAGTACA
GACACGTCTTATGTTTAAC -> ACACGTCTTATGTTTAACT
GACAGCCTAGGCATGCAGG -> ACAGCCTAGGCATGCAGGA
GACAGTAGGGATCCCCGCG -> ACAGTAGGGATCCCCGCGG
GACCACAAGTTTGTACCGG -> ACCACAAGTTTGTACCGGG
GACCATAAGGAATAATATC -> ACCATAAGGAATAATATCG
GACCATGCTCGAGGTACAG -> ACCATGCTCGAGGTACAGA
GACCCCAGACACGAATGGT -> ACCCCAGACACGAATGGTA
GACCCCGCAGTGCGTCAAG -> ACCCCGCAGTGCGTCAAGG
GACCCTTAACCGTCGTACG -> ACCCTTAACCGTCGTACGA
GACCGCCCAGGCCGCGGCC -> ACCGCCCAGGCCGCGGCCT
GACCGCTTCCTTGGGCTGA -> ACCGCTTCCTTGGGCTGAA
GACCTTCGTAGAATTGCGG -> ACCTTCGTAGAATTGCGGT
GACGACGCTCAAGTAGGGA -> ACGACGCTCAAGTAGGGAT
GACGATACCATGCCTTCGT -> ACGATACCATGCCTTCGTT
GACGATCGTCTTACGTCAA -> ACGATCGTCTTACGTCAAC
GACGCCTATGCGAAGCTCG -> ACGCCTATGCGAAGCTCGC
GACGCTCAAGTAGGGATCC -> ACGCTCAAGTAGGGATCCC
GACGGACCATAAGGAATAA -> ACGGACCATAAGGAATAAT
GACGGTATGCCTTGGGGAA -> ACGGTATGCCTTGGGGAAT
GACGGTGTATTGCCACTGT -> ACGGTGTATTGCCACTGTA
GACGGTTCTTTTGAATATC -> ACGGTTCTTTTGAATATCT
GACTAAACATATGAGGAGG -> ACTAAACATATGAGGAGGG
GACTAGCAACACTTACTGG -> ACTAGCAACACTTACTGGT
GACTAGGTGCCTCAGCAAC -> ACTAGGTGCCTCAGCAACC
GACTCGATCTGTATGGGAC -> ACTCGATCTGTATGGGACC
GACTGAATCCAACGAAGGC -> ACTGAATCCAACGAAGGCT
GACTGCACGACGCCTATGC -> ACTGCACGACGCCTATGCG
GACTTAACGTCTATTCATA -> ACTTAACGTCTATTCATAA
GACTTCAGGGACGGTATGC -> ACTTCAGGGACGGTATGCC
GAGACAATGTATGAGTGCA -> AGACAATGTATGAGTGCAT
GAGACCTTCGTAGAATTGC -> AGACCTTCGTAGAATTGCG
GAGATGCCAGACACGTCTT -> AGATGCCAGACACGTCTTA
GAGATGCTCATTAATAAAG -> AGATGCTCATTAATAAAGC
GAGCGCCCTAGGAATATCA -> AGCGCCCTAGGAATATCAG
GAGCGTCACTGCAGAGTGA -> AGCGTCACTGCAGAGTGAT
GAGCTTTCACGGAGATGCC -> AGCTTTCACGGAGATGCCA
GAGGACCCCAGACACGAAT -> AGGACCCCAGACACGAATG
GAGGACGGTTCTTTTGAAT -> AGGACGGTTCTTTTGAATA
GAGGAGGCCCGACGGTGTA -> AGGAGGCCCGACGGTGTAT
GAGGAGGGGCCCATTGAAC -> AGGAGGGGCCCATTGAACA
GAGGCAGAGGACCCCAGAC -> AGGCAGAGGACCCCAGACA
GAGGCCCGACGGTGTATTG -> AGGCCCGACGGTGTATTGC
GAGGCGCGTTTATGGATCT -> AGGCGCGTTTATGGATCTC
GAGGCTAAATAGCAACCCC -> AGGCTAAATAGCAACCCCC
GAGGCTCGGGGCCAAAGTA -> AGGCTCGGGGCCAAAGTAG
GAGGGGCCCATTGAACATA -> AGGGGCCCATTGAACATAC
GAGGTACAGATTTTGCAAA -> AGGTACAGATTTTGCAAAC
GAGGTGTATCATAGACCGC -> AGGTGTATCATAGACCGCT
GAGTACTTCATGGGTGGTT -> AGTACTTCATGGGTGGTTG
GAGTCGGTTTACGAACCAC -> AGTCGGTTTACGAACCACC
GAGTGAGTTAGCAGTTACC -> AGTGAGTTAGCAGTTACCC
GAGTGATCGTTAATTCTTC -> AGTGATCGTTAATTCTTCC
GAGTGCATATTGCAAGTGT -> AGTGCATATTGCAAGTGTG
GAGTGGGGGGAGTTTATAA -> AGTGGGGGGAGTTTATAAT
GAGTTAGCAGTTACCCCTT -> AGTTAGCAGTTACCCCTTT
GAGTTATGTTCTCCGAATA -> AGTTATGTTCTCCGAATAG
GAGTTTATAATCATTTATA -> AGTTTATAATCATTTATAA
GATAACCAATGAGGCAGAG -> ATAACCAATGAGGCAGAGG
GATACCATGCCTTCGTTTC -> ATACCATGCCTTCGTTTCA
GATACCTTGGTATACCCCG -> ATACCTTGGTATACCCCGT
GATATGGCCCTCCCGTGAC -> ATATGGCCCTCCCGTGACT
GATCAAGCGCGAATGCAAG -> ATCAAGCGCGAATGCAAGT
GATCACCGAGCTTTCACGG -> ATCACCGAGCTTTCACGGA
GATCAGCCGCGTACCCCTC -> ATCAGCCGCGTACCCCTCT
GATCCCCGCGGGTATGTTG -> ATCCCCGCGGGTATGTTGT
GATCCCCGCGGGTCTGACT -> ATCCCCGCGGGTCTGACTG
GATCCCCGCGGGTTCCCGC -> ATCCCCGCGGGTTCCCGCA
GATCCCCGCGGGTTTACGG -> ATCCCCGCGGGTTTACGGA
GATCGTCTTACGTCAACTA -> ATCGTCTTACGTCAACTAC
GATCGTTAATTCTTCCCAT -> ATCGTTAATTCTTCCCATC
GATCTCATTTCCATAAGTC -> ATCTCATTTCCATAAGTCT
GATCTGTATGGGACCATGC -> ATCTGTATGGGACCATGCT
GATGAAAGCATTTGACTTA -> ATGAAAGCATTTGACTTAA
GATGAAATTCTTGTTTCCC -> ATGAAATTCTTGTTTCCCA
GATGCACTTTCGCCGTTGT -> ATGCACTTTCGCCGTTGTA
GATGCCAGACACGTCTTAT -> ATGCCAGACACGTCTTATG
GATGCCTTCGAGGAGGCCC -> ATGCCTTCGAGGAGGCCCG
GATGCTCATTAATAAAGCG -> ATGCTCATTAATAAAGCGA
GATGTGCTAACAAAGACTA -> ATGTGCTAACAAAGACTAG
GATGTGTACTCTTCGGACG -> ATGTGTACTCTTCGGACGA
GATGTGTAGCCGAAACAGC -> ATGTGTAGCCGAAACAGCG
GATTACACCAAAGATCAGC -> ATTACACCAAAGATCAGCC
GATTAGCTTCTCCGTTTTC -> ATTAGCTTCTCCGTTTTCA
GATTCAGCACTTGCTCAAC -> ATTCAGCACTTGCTCAACG
GATTCCCACCCCGTCTCTG -> ATTCCCACCCCGTCTCTGG
GATTCCGAAAAGCCGGCCA -> ATTCCGAAAAGCCGGCCAT
GATTTACTTCTAAGCTAAC -> ATTTACTTCTAAGCTAACC
GATTTCAATTAGCTAAGCC -> ATTTCAATTAGCTAAGCCT
GATTTCTTACCCAGGACGA -> ATTTCTTACCCAGGACGAT
GATTTTGCAAACATGGAAC -> ATTTTGCAAACATGGAACG
GCAAACATGGAACGCACGA -> CAAACATGGAACGCACGAC
GCAAACCATTAAGCTATCC -> CAAACCATTAAGCTATCCG
GCAAACCATTACACAGCCT -> CAAACCATTACACAGCCTC
GCAAACCATTAGACGACGC -> CAAACCATTAGACGACGCT
GCAAACCATTATCGGTGCT -> CAAACCATTATCGGTGCTG
GCAACACTTACTGGTTCGC -> CAACACTTACTGGTTCGCG
GCAACCCCCCTTCAGACTA -> CAACCCCCCTTCAGACTAA
GCAACCGAACGTTGGGAGG -> CAACCGAACGTTGGGAGGC
GCAAGGAGACCTTCGTAGA -> CAAGGAGACCTTCGTAGAA
GCAAGTCTGGCTCACTTCC -> CAAGTCTGGCTCACTTCCC
GCAAGTGTGTGGCCCAGTT -> CAAGTGTGTGGCCCAGTTC
GCAATCCAGGCCCATGGCA -> CAATCCAGGCCCATGGCAT
GCAATGGCCGCTTACCACC -> CAATGGCCGCTTACCACCG
GCACCCCTGAATCCATCTG -> CACCCCTGAATCCATCTGT
GCACGAAGGGGACCACAAG -> CACGAAGGGGACCACAAGT
GCACGACGCCTATGCGAAG -> CACGACGCCTATGCGAAGC
GCACGACTAGGTGCCTCAG -> CACGACTAGGTGCCTCAGC
GCACTGACTCGATCTGTAT -> CACTGACTCGATCTGTATG
GCACTGATGCACTTTCGCC -> CACTGATGCACTTTCGCCG
GCACTTGCTCAACGCAAAC -> CACTTGCTCAACGCAAACC
GCACTTTCGCCGTTGTATG -> CACTTTCGCCGTTGTATGC
GCAGAGGACCCCAGACACG -> CAGAGGACCCCAGACACGA
GCAGAGTGATCGTTAATTC -> CAGAGTGATCGTTAATTCT
GCAGGATGAAATTCTTGTT -> CAGGATGAAATTCTTGTTT
GCAGTGCGTCAAGGGGCGC -> CAGTGCGTCAAGGGGCGCC
GCAGTTACCCCTTTGAATA -> CAGTTACCCCTTTGAATAG
GCATAGCGCCTGATGCCTT -> CATAGCGCCTGATGCCTTC
GCATATTGCAAGTGTGTGG -> CATATTGCAAGTGTGTGGC
GCATGCAGGATGAAATTCT -> CATGCAGGATGAAATTCTT
GCATGCCGACACCATCTTC -> CATGCCGACACCATCTTCT
GCATGGAAACATCATGGTA -> CATGGAAACATCATGGTAA
GCATTACCGCTTGTGACCC -> CATTACCGCTTGTGACCCC
GCATTTGACTTAACGTCTA -> CATTTGACTTAACGTCTAT
GCCAAAGTAGAGACAATGT -> CCAAAGTAGAGACAATGTA
GCCACTGTATGTCATTCGA -> CCACTGTATGTCATTCGAT
GCCAGACACGTCTTATGTT -> CCAGACACGTCTTATGTTT
GCCATTTGGAGATGCTCAT -> CCATTTGGAGATGCTCATT
GCCCAGGCCGCGGCCTCGG -> CCCAGGCCGCGGCCTCGGG
GCCCAGTTCAAGGATTTAC -> CCCAGTTCAAGGATTTACT
GCCCATCCTGATCAAGCGC -> CCCATCCTGATCAAGCGCG
GCCCATGGCATAGCGCCTG -> CCCATGGCATAGCGCCTGA
GCCCATTGAACATACGGCT -> CCCATTGAACATACGGCTG
GCCCCACACGGTGTACAGC -> CCCCACACGGTGTACAGCT
GCCCGACGGTGTATTGCCA -> CCCGACGGTGTATTGCCAC
GCCCGCACCCCTGAATCCA -> CCCGCACCCCTGAATCCAT
GCCCGTAAAACGAGGTGTA -> CCCGTAAAACGAGGTGTAT
GCCCGTTTGTCTATCATTT -> CCCGTTTGTCTATCATTTG
GCCCTAGGAATATCAGCGC -> CCCTAGGAATATCAGCGCT
GCCCTCCCGTGACTTCAGG -> CCCTCCCGTGACTTCAGGG
GCCGAAACAGCGCTCCACC -> CCGAAACAGCGCTCCACCT
GCCGAAGCGCGCAAGGAGA -> CCGAAGCGCGCAAGGAGAC
GCCGACACCATCTTCTGAG -> CCGACACCATCTTCTGAGT
GCCGCGTACCCCTCTGTTA -> CCGCGTACCCCTCTGTTAT
GCCGCTTACCACCGCCGTC -> CCGCTTACCACCGCCGTCA
GCCGGCCATTTGGAGATGC -> CCGGCCATTTGGAGATGCT
GCCGTCACCGCCTCCTTTG -> CCGTCACCGCCTCCTTTGT
GCCGTCTTATTGATATGGC -> CCGTCTTATTGATATGGCC
GCCGTGCACGAAGGGGACC -> CCGTGCACGAAGGGGACCA
GCCGTTGTATGCATGGAAA -> CCGTTGTATGCATGGAAAC
GCCTAGGCATGCAGGATGA -> CCTAGGCATGCAGGATGAA
GCCTATATTCGTATCGAAC -> CCTATATTCGTATCGAACA
GCCTATGCGAAGCTCGCTA -> CCTATGCGAAGCTCGCTAC
GCCTCAGCAACCGAACGTT -> CCTCAGCAACCGAACGTTG
GCCTCCTGGTCGTAAACCT -> CCTCCTGGTCGTAAACCTG
GCCTCCTTTGTCTGACTGA -> CCTCCTTTGTCTGACTGAA
GCCTCGTAGTAGGGATCCC -> CCTCGTAGTAGGGATCCCC
GCCTCTGAGTACTTCATGG -> CCTCTGAGTACTTCATGGG
GCCTGATGCCTTCGAGGAG -> CCTGATGCCTTCGAGGAGG
GCCTGCCTCTGAGTACTTC -> CCTGCCTCTGAGTACTTCA
GCCTTCGAGGAGGCCCGAC -> CCTTCGAGGAGGCCCGACG
GCCTTCGTTTCAGTTAGAA -> CCTTCGTTTCAGTTAGAAT
GCCTTCTCACAAGGCTGAT -> CCTTCTCACAAGGCTGATT
GCCTTGGGGAATCGGCTCA -> CCTTGGGGAATCGGCTCAA
GCGAACGCCGAAGCGCGCA -> CGAACGCCGAAGCGCGCAA
GCGAAGCTCGCTACTATCG -> CGAAGCTCGCTACTATCGA
GCGAATGCAAGTCTGGCTC -> CGAATGCAAGTCTGGCTCA
GCGACAAATAGTGCGCTCA -> CGACAAATAGTGCGCTCAA
GCGATGTGTACTCTTCGGA -> CGATGTGTACTCTTCGGAC
GCGCAAGGAGACCTTCGTA -> CGCAAGGAGACCTTCGTAG
GCGCCCCACACGGTGTACA -> CGCCCCACACGGTGTACAG
GCGCCCTAGGAATATCAGC -> CGCCCTAGGAATATCAGCG
GCGCCTGATGCCTTCGAGG -> CGCCTGATGCCTTCGAGGA
GCGCGAATGCAAGTCTGGC -> CGCGAATGCAAGTCTGGCT
GCGCGCAAGGAGACCTTCG -> CGCGCAAGGAGACCTTCGT
GCGCGTTTATGGATCTCAT -> CGCGTTTATGGATCTCATT
GCGCTCAACGCAAACCATT -> CGCTCAACGCAAACCATTA
GCGCTCCACCTATCCTCGG -> CGCTCCACCTATCCTCGGA
GCGCTCTGTCAGTATCCCG -> CGCTCTGTCAGTATCCCGC
GCGCTGCCGTCTTATTGAT -> CGCTGCCGTCTTATTGATA
GCGGGTATGTTGTTACCCG -> CGGGTATGTTGTTACCCGC
GCGGGTCTGACTGCACGAC -> CGGGTCTGACTGCACGACG
GCGGGTTCCCGCATGCCGA -> CGGGTTCCCGCATGCCGAC
GCGGGTTTACGGAGGACGG -> CGGGTTTACGGAGGACGGT
GCGGTATGAGTTATGTTCT -> CGGTATGAGTTATGTTCTC
GCGGTCTATGTGCATTACC -> CGGTCTATGTGCATTACCG
GCGTACCCCTCTGTTATGT -> CGTACCCCTCTGTTATGTC
GCGTAGGAGCGTCACTGCA -> CGTAGGAGCGTCACTGCAG
GCGTCAAGGGGCGCCCCAC -> CGTCAAGGGGCGCCCCACA
GCGTCACTGCAGAGTGATC -> CGTCACTGCAGAGTGATCG
GCGTGCGAACGCCGAAGCG -> CGTGCGAACGCCGAAGCGC
GCGTGGCCTGCCTCTGAGT -> CGTGGCCTGCCTCTGAGTA
GCGTTTATGGATCTCATTT -> CGTTTATGGATCTCATTTC
GCTAAATAGCAACCCCCCT -> CTAAATAGCAACCCCCCTT
GCTAACAAAGACTAGCAAC -> CTAACAAAGACTAGCAACA
GCTAACCTACATGCTATAG -> CTAACCTACATGCTATAGG
GCTAAGCCTTCTCACAAGG -> CTAAGCCTTCTCACAAGGC
GCTACATCGATAACCAATG -> CTACATCGATAACCAATGA
GCTACGTGGTGCCTATATT -> CTACGTGGTGCCTATATTC
GCTACTATCGAACAGGGAG -> CTACTATCGAACAGGGAGT
GCTATAGGATACCTTGGTA -> CTATAGGATACCTTGGTAT
GCTATCCGACAGTAGGGAT -> CTATCCGACAGTAGGGATC
GCTATTTGGCTACATCGAT -> CTATTTGGCTACATCGATA
GCTCAACGCAAACCATTAA -> CTCAACGCAAACCATTAAG
GCTCAACGCAAACCATTAC -> CTCAACGCAAACCATTACA
GCTCAACGCAAACCATTAG -> CTCAACGCAAACCATTAGA
GCTCAACGCAAACCATTAT -> CTCAACGCAAACCATTATC
GCTCAAGTAGGGATCCCCG -> CTCAAGTAGGGATCCCCGC
GCTCACTTCCCACGGTAAC -> CTCACTTCCCACGGTAACA
GCTCATTAATAAAGCGATG -> CTCATTAATAAAGCGATGT
GCTCCACCTATCCTCGGAA -> CTCCACCTATCCTCGGAAA
GCTCGAGGTACAGATTTTG -> CTCGAGGTACAGATTTTGC
GCTCGCTACTATCGAACAG -> CTCGCTACTATCGAACAGG
GCTCGGGGCCAAAGTAGAG -> CTCGGGGCCAAAGTAGAGA
GCTCTGTCAGTATCCCGCA -> CTCTGTCAGTATCCCGCAA
GCTGAAATCCTATCCCAGT -> CTGAAATCCTATCCCAGTG
GCTGAGTGGGGGGAGTTTA -> CTGAGTGGGGGGAGTTTAT
GCTGATTCAGCACTTGCTC -> CTGATTCAGCACTTGCTCA
GCTGCCGTCTTATTGATAT -> CTGCCGTCTTATTGATATG
GCTGTTAGTAGGGATCCCC -> CTGTTAGTAGGGATCCCCG
GCTTACCACCGCCGTCACC -> CTTACCACCGCCGTCACCG
GCTTCCTTGGGCTGAAATC -> CTTCCTTGGGCTGAAATCC
GCTTCTCCGTTTTCATTCG -> CTTCTCCGTTTTCATTCGT
GCTTGTGACCCCGCAGTGC -> CTTGTGACCCCGCAGTGCG
GCTTTCACGGAGATGCCAG -> CTTTCACGGAGATGCCAGA
GGAAACATCATGGTAACCC -> GAAACATCATGGTAACCCG
GGAAACTAGTACGACGGAC -> GAAACTAGTACGACGGACC
GGAACGCACGACTAGGTGC -> GAACGCACGACTAGGTGCC
GGAATAATATCGATTCCCA -> GAATAATATCGATTCCCAC
GGAATATCAGCGCTCTGTC -> GAATATCAGCGCTCTGTCA
GGAATCGGCTCAACGCAAA -> GAATCGGCTCAACGCAAAC
GGACCACAAGTTTGTACCG -> GACCACAAGTTTGTACCGG
GGACCATAAGGAATAATAT -> GACCATAAGGAATAATATC
GGACCATGCTCGAGGTACA -> GACCATGCTCGAGGTACAG
GGACCCCAGACACGAATGG -> GACCCCAGACACGAATGGT
GGACGATACCATGCCTTCG -> GACGATACCATGCCTTCGT
GGACGATCGTCTTACGTCA -> GACGATCGTCTTACGTCAA
GGACGGTATGCCTTGGGGA -> GACGGTATGCCTTGGGGAA
GGACGGTTCTTTTGAATAT -> GACGGTTCTTTTGAATATC
GGAGACCTTCGTAGAATTG -> GAGACCTTCGTAGAATTGC
GGAGATGCCAGACACGTCT -> GAGATGCCAGACACGTCTT
GGAGATGCTCATTAATAAA -> GAGATGCTCATTAATAAAG
GGAGCGTCACTGCAGAGTG -> GAGCGTCACTGCAGAGTGA
GGAGGACGGTTCTTTTGAA -> GAGGACGGTTCTTTTGAAT
GGAGGCCCGACGGTGTATT -> GAGGCCCGACGGTGTATTG
GGAGGCGCGTTTATGGATC -> GAGGCGCGTTTATGGATCT
GGAGGCTAAATAGCAACCC -> GAGGCTAAATAGCAACCCC
GGAGGCTCGGGGCCAAAGT -> GAGGCTCGGGGCCAAAGTA
GGAGGGGCCCATTGAACAT -> GAGGGGCCCATTGAACATA
GGAGTCGGTTTACGAACCA -> GAGTCGGTTTACGAACCAC
GGAGTTTATAATCATTTAT -> GAGTTTATAATCATTTATA
GGATACCTTGGTATACCCC -> GATACCTTGGTATACCCCG
GGATCCCCGCGGGTATGTT -> GATCCCCGCGGGTATGTTG
GGATCCCCGCGGGTCTGAC -> GATCCCCGCGGGTCTGACT
GGATCCCCGCGGGTTCCCG -> GATCCCCGCGGGTTCCCGC
GGATCCCCGCGGGTTTACG -> GATCCCCGCGGGTTTACGG
GGATCTCATTTCCATAAGT -> GATCTCATTTCCATAAGTC
GGATGAAAGCATTTGACTT -> GATGAAAGCATTTGACTTA
GGATGAAATTCTTGTTTCC -> GATGAAATTCTTGTTTCCC
GGATGTGCTAACAAAGACT -> GATGTGCTAACAAAGACTA
GGATTAGCTTCTCCGTTTT -> GATTAGCTTCTCCGTTTTC
GGATTTACTTCTAAGCTAA -> GATTTACTTCTAAGCTAAC
GGATTTCAATTAGCTAAGC -> GATTTCAATTAGCTAAGCC
GGCACTGACTCGATCTGTA -> GCACTGACTCGATCTGTAT
GGCAGAGGACCCCAGACAC -> GCAGAGGACCCCAGACACG
GGCATAGCGCCTGATGCCT -> GCATAGCGCCTGATGCCTT
GGCATGCAGGATGAAATTC -> GCATGCAGGATGAAATTCT
GGCCAAAGTAGAGACAATG -> GCCAAAGTAGAGACAATGT
GGCCATTTGGAGATGCTCA -> GCCATTTGGAGATGCTCAT
GGCCCAGTTCAAGGATTTA -> GCCCAGTTCAAGGATTTAC
GGCCCATGGCATAGCGCCT -> GCCCATGGCATAGCGCCTG
GGCCCATTGAACATACGGC -> GCCCATTGAACATACGGCT
GGCCCGACGGTGTATTGCC -> GCCCGACGGTGTATTGCCA
GGCCCTCCCGTGACTTCAG -> GCCCTCCCGTGACTTCAGG
GGCCGCTTACCACCGCCGT -> GCCGCTTACCACCGCCGTC
GGCCTGCCTCTGAGTACTT -> GCCTGCCTCTGAGTACTTC
GGCGCCCCACACGGTGTAC -> GCGCCCCACACGGTGTACA
GGCGCGTTTATGGATCTCA -> GCGCGTTTATGGATCTCAT
GGCTAAATAGCAACCCCCC -> GCTAAATAGCAACCCCCCT
GGCTACATCGATAACCAAT -> GCTACATCGATAACCAATG
GGCTACGTGGTGCCTATAT -> GCTACGTGGTGCCTATATT
GGCTCAACGCAAACCATTA -> GCTCAACGCAAACCATTAG
GGCTCACTTCCCACGGTAA -> GCTCACTTCCCACGGTAAC
GGCTCGGGGCCAAAGTAGA -> GCTCGGGGCCAAAGTAGAG
GGCTGAAATCCTATCCCAG -> GCTGAAATCCTATCCCAGT
GGCTGAGTGGGGGGAGTTT -> GCTGAGTGGGGGGAGTTTA
GGCTGATTCAGCACTTGCT -> GCTGATTCAGCACTTGCTC
GGGAATCGGCTCAACGCAA -> GGAATCGGCTCAACGCAAA
GGGACCACAAGTTTGTACC -> GGACCACAAGTTTGTACCG
GGGACCATGCTCGAGGTAC -> GGACCATGCTCGAGGTACA
GGGACGGTATGCCTTGGGG -> GGACGGTATGCCTTGGGGA
GGGAGGCGCGTTTATGGAT -> GGAGGCGCGTTTATGGATC
GGGAGGCTCGGGGCCAAAG -> GGAGGCTCGGGGCCAAAGT
GGGAGTCGGTTTACGAACC -> GGAGTCGGTTTACGAACCA
GGGAGTTTATAATCATTTA -> GGAGTTTATAATCATTTAT
GGGATCCCCGCGGGTATGT -> GGATCCCCGCGGGTATGTT
GGGATCCCCGCGGGTCTGA -> GGATCCCCGCGGGTCTGAC
GGGATCCCCGCGGGTTCCC -> GGATCCCCGCGGGTTCCCG
GGGATCCCCGCGGGTTTAC -> GGATCCCCGCGGGTTTACG
GGGATGAAAGCATTTGACT -> GGATGAAAGCATTTGACTT
GGGATTAGCTTCTCCGTTT -> GGATTAGCTTCTCCGTTTT
GGGATTTCAATTAGCTAAG -> GGATTTCAATTAGCTAAGC
GGGCCAAAGTAGAGACAAT -> GGCCAAAGTAGAGACAATG
GGGCCCATTGAACATACGG -> GGCCCATTGAACATACGGC
GGGCGCCCCACACGGTGTA -> GGCGCCCCACACGGTGTAC
GGGCTGAAATCCTATCCCA -> GGCTGAAATCCTATCCCAG
GGGGAATCGGCTCAACGCA -> GGGAATCGGCTCAACGCAA
GGGGACCACAAGTTTGTAC -> GGGACCACAAGTTTGTACC
GGGGAGGCTCGGGGCCAAA -> GGGAGGCTCGGGGCCAAAG
GGGGAGTTTATAATCATTT -> GGGAGTTTATAATCATTTA
GGGGATTTCAATTAGCTAA -> GGGATTTCAATTAGCTAAG
GGGGCCAAAGTAGAGACAA -> GGGCCAAAGTAGAGACAAT
GGGGCCCATTGAACATACG -> GGGCCCATTGAACATACGG
GGGGCGCCCCACACGGTGT -> GGGCGCCCCACACGGTGTA
GGGGGAGTTTATAATCATT -> GGGGAGTTTATAATCATTT
GGGGGGAGTTTATAATCAT -> GGGGGAGTTTATAATCATT
GGGTATGTTGTTACCCGCC -> GGTATGTTGTTACCCGCCG
GGGTCTGACTGCACGACGC -> GGTCTGACTGCACGACGCC
GGGTGCAATCCAGGCCCAT -> GGTGCAATCCAGGCCCATG
GGGTGGAGGCTAAATAGCA -> GGTGGAGGCTAAATAGCAA
GGGTGGTTGCTATTTGGCT -> GGTGGTTGCTATTTGGCTA
GGGTTCCCGCATGCCGACA -> GGTTCCCGCATGCCGACAC
GGGTTCTGGGTGGAGGCTA -> GGTTCTGGGTGGAGGCTAA
GGGTTTACGGAGGACGGTT -> GGTTTACGGAGGACGGTTC
GGTAAAGTACACAAGTATG -> GTAAAGTACACAAGTATGT
GGTAACAAATAACAGCGTG -> GTAACAAATAACAGCGTGG
GGTAACCCGGGATTAGCTT -> GTAACCCGGGATTAGCTTC
GGTACAGATTTTGCAAACA -> GTACAGATTTTGCAAACAT
GGTACTGGGTGCAATCCAG -> GTACTGGGTGCAATCCAGG
GGTATACCCCGTTATAAGA -> GTATACCCCGTTATAAGAT
GGTATGAGTTATGTTCTCC -> GTATGAGTTATGTTCTCCG
GGTATGCCTTGGGGAATCG -> GTATGCCTTGGGGAATCGG
GGTATGTTGTTACCCGCCG -> GTATGTTGTTACCCGCCGT
GGTCGTAAACCTGTCTCCA -> GTCGTAAACCTGTCTCCAA
GGTCTATGTGCATTACCGC -> GTCTATGTGCATTACCGCT
GGTCTGACTGCACGACGCC -> GTCTGACTGCACGACGCCT
GGTCTTTGCCCGTTTGTCT -> GTCTTTGCCCGTTTGTCTA
GGTGCAATCCAGGCCCATG -> GTGCAATCCAGGCCCATGG
GGTGCCTATATTCGTATCG -> GTGCCTATATTCGTATCGA
GGTGCCTCAGCAACCGAAC -> GTGCCTCAGCAACCGAACG
GGTGCTGTTAGTAGGGATC -> GTGCTGTTAGTAGGGATCC
GGTGGAGGCTAAATAGCAA -> GTGGAGGCTAAATAGCAAC
GGTGGTTGCTATTTGGCTA -> GTGGTTGCTATTTGGCTAC
GGTGTACAGCTCAACGCAA -> GTGTACAGCTCAACGCAAA
GGTGTATCATAGACCGCTT -> GTGTATCATAGACCGCTTC
GGTGTATTGCCACTGTATG -> GTGTATTGCCACTGTATGT
GGTTCCCGCATGCCGACAC -> GTTCCCGCATGCCGACACC
GGTTCGCGCTGCCGTCTTA -> GTTCGCGCTGCCGTCTTAT
GGTTCTGGGTGGAGGCTAA -> GTTCTGGGTGGAGGCTAAA
GGTTCTTTTGAATATCTAG -> GTTCTTTTGAATATCTAGT
GGTTGCTATTTGGCTACAT -> GTTGCTATTTGGCTACATC
GGTTTACGAACCACCGTCT -> GTTTACGAACCACCGTCTC
GGTTTACGGAGGACGGTTC -> GTTTACGGAGGACGGTTCT
GTAAAACGAGGTGTATCAT -> TAAAACGAGGTGTATCATA
GTAAACCTGTCTCCAAACT -> TAAACCTGTCTCCAAACTC
GTAAAGTACACAAGTATGT -> TAAAGTACACAAGTATGTC
GTAACAAATAACAGCGTGG -> TAACAAATAACAGCGTGGC
GTAACCCGGGATTAGCTTC -> TAACCCGGGATTAGCTTCT
GTACACAAGTATGTCGACA -> TACACAAGTATGTCGACAG
GTACAGATTTTGCAAACAT -> TACAGATTTTGCAAACATG
GTACAGCTCAACGCAAACC -> TACAGCTCAACGCAAACCA
GTACCCCTCTGTTATGTCT -> TACCCCTCTGTTATGTCTC
GTACCGGGGAGGCTCGGGG -> TACCGGGGAGGCTCGGGGC
GTACGACGGACCATAAGGA -> TACGACGGACCATAAGGAA
GTACGAGCGCCCTAGGAAT -> TACGAGCGCCCTAGGAATA
GTACGGGTTCTGGGTGGAG -> TACGGGTTCTGGGTGGAGG
GTACGTGCACTGATGCACT -> TACGTGCACTGATGCACTT
GTACTCTTCGGACGATACC -> TACTCTTCGGACGATACCA
GTACTGGGTGCAATCCAGG -> TACTGGGTGCAATCCAGGC
GTACTTCATGGGTGGTTGC -> TACTTCATGGGTGGTTGCT
GTAGAATTGCGGTATGAGT -> TAGAATTGCGGTATGAGTT
GTAGAGACAATGTATGAGT -> TAGAGACAATGTATGAGTG
GTAGCCGAAACAGCGCTCC -> TAGCCGAAACAGCGCTCCA
GTAGGAGCGTCACTGCAGA -> TAGGAGCGTCACTGCAGAG
GTAGGGATCCCCGCGGGTA -> TAGGGATCCCCGCGGGTAT
GTAGGGATCCCCGCGGGTC -> TAGGGATCCCCGCGGGTCT
GTAGGGATCCCCGCGGGTT -> TAGGGATCCCCGCGGGTTC,TAGGGATCCCCGCGGGTTT
GTAGTAGGGATCCCCGCGG -> TAGTAGGGATCCCCGCGGG
GTATACCCCGTTATAAGAT -> TATACCCCGTTATAAGATT
GTATCATAGACCGCTTCCT -> TATCATAGACCGCTTCCTT
GTATCCCGCAATGGCCGCT -> TATCCCGCAATGGCCGCTT
GTATCGAACACAATCTTTT -> TATCGAACACAATCTTTTC
GTATGAGTGCATATTGCAA -> TATGAGTGCATATTGCAAG
GTATGAGTTATGTTCTCCG -> TATGAGTTATGTTCTCCGA
GTATGCATGGAAACATCAT -> TATGCATGGAAACATCATG
GTATGCCTTGGGGAATCGG -> TATGCCTTGGGGAATCGGC
GTATGGGACCATGCTCGAG -> TATGGGACCATGCTCGAGG
GTATGTCATTCGATGTGTA -> TATGTCATTCGATGTGTAG
GTATGTCGACAGCCTAGGC -> TATGTCGACAGCCTAGGCA
GTATGTTGTTACCCGCCGT -> TATGTTGTTACCCGCCGTG
GTATTGCCACTGTATGTCA -> TATTGCCACTGTATGTCAT
GTCAACTACATTTTACCTC -> TCAACTACATTTTACCTCC
GTCAAGGGGCGCCCCACAC -> TCAAGGGGCGCCCCACACG
GTCACCCGCGTAGGAGCGT -> TCACCCGCGTAGGAGCGTC
GTCACCGCCTCCTTTGTCT -> TCACCGCCTCCTTTGTCTG
GTCACTGCAGAGTGATCGT -> TCACTGCAGAGTGATCGTT
GTCAGTACGGGTTCTGGGT -> TCAGTACGGGTTCTGGGTG
GTCAGTATCCCGCAATGGC -> TCAGTATCCCGCAATGGCC
GTCATTCGATGTGTAGCCG -> TCATTCGATGTGTAGCCGA
GTCCCTGGTCTTTGCCCGT -> TCCCTGGTCTTTGCCCGTT
GTCGACAGCCTAGGCATGC -> TCGACAGCCTAGGCATGCA
GTCGCGACAAATAGTGCGC -> TCGCGACAAATAGTGCGCT
GTCGGTTTACGAACCACCG -> TCGGTTTACGAACCACCGT
GTCGTAAACCTGTCTCCAA -> TCGTAAACCTGTCTCCAAA
GTCGTACGAGCGCCCTAGG -> TCGTACGAGCGCCCTAGGA
GTCTAATTAGATTTCTTAC -> TCTAATTAGATTTCTTACC
GTCTATCATTTGTCAGTAC -> TCTATCATTTGTCAGTACG
GTCTATGTGCATTACCGCT -> TCTATGTGCATTACCGCTT
GTCTATTCATAACGGTACT -> TCTATTCATAACGGTACTG
GTCTCAGCGGTCTATGTGC -> TCTCAGCGGTCTATGTGCA
GTCTCCAAACTCCATTGTA -> TCTCCAAACTCCATTGTAC
GTCTCCCTAACTCCGCCCA -> TCTCCCTAACTCCGCCCAT
GTCTCTGGATGTGCTAACA -> TCTCTGGATGTGCTAACAA
GTCTGACTGAATCCAACGA -> TCTGACTGAATCCAACGAA
GTCTGACTGCACGACGCCT -> TCTGACTGCACGACGCCTA
GTCTGGCTCACTTCCCACG -> TCTGGCTCACTTCCCACGG
GTCTTACGTCAACTACATT -> TCTTACGTCAACTACATTT
GTCTTATGTTTAACTCACA -> TCTTATGTTTAACTCACAT
GTCTTATTGATATGGCCCT -> TCTTATTGATATGGCCCTC
GTCTTTGCCCGTTTGTCTA -> TCTTTGCCCGTTTGTCTAT
GTGACCCCGCAGTGCGTCA -> TGACCCCGCAGTGCGTCAA
GTGACTTCAGGGACGGTAT -> TGACTTCAGGGACGGTATG
GTGAGTTAGCAGTTACCCC -> TGAGTTAGCAGTTACCCCT
GTGATCGTTAATTCTTCCC -> TGATCGTTAATTCTTCCCA
GTGCAATCCAGGCCCATGG -> TGCAATCCAGGCCCATGGC
GTGCACGAAGGGGACCACA -> TGCACGAAGGGGACCACAA
GTGCACTGATGCACTTTCG -> TGCACTGATGCACTTTCGC
GTGCATATTGCAAGTGTGT -> TGCATATTGCAAGTGTGTG
GTGCATTACCGCTTGTGAC -> TGCATTACCGCTTGTGACC
GTGCCTATATTCGTATCGA -> TGCCTATATTCGTATCGAA
GTGCCTCAGCAACCGAACG -> TGCCTCAGCAACCGAACGT
GTGCGAACGCCGAAGCGCG -> TGCGAACGCCGAAGCGCGC
GTGCGCTCAACGCAAACCA -> TGCGCTCAACGCAAACCAT
GTGCGTCAAGGGGCGCCCC -> TGCGTCAAGGGGCGCCCCA
GTGCTAACAAAGACTAGCA -> TGCTAACAAAGACTAGCAA
GTGCTGTTAGTAGGGATCC -> TGCTGTTAGTAGGGATCCC
GTGGAGGCTAAATAGCAAC -> TGGAGGCTAAATAGCAACC
GTGGCACTGACTCGATCTG -> TGGCACTGACTCGATCTGT
GTGGCCCAGTTCAAGGATT -> TGGCCCAGTTCAAGGATTT
GTGGCCTGCCTCTGAGTAC -> TGGCCTGCCTCTGAGTACT
GTGGGGGGAGTTTATAATC -> TGGGGGGAGTTTATAATCA
GTGGTGCCTATATTCGTAT -> TGGTGCCTATATTCGTATC
GTGGTTGCTATTTGGCTAC -> TGGTTGCTATTTGGCTACA
GTGTACAGCTCAACGCAAA -> TGTACAGCTCAACGCAAAC
GTGTACTCTTCGGACGATA -> TGTACTCTTCGGACGATAC
GTGTAGCCGAAACAGCGCT -> TGTAGCCGAAACAGCGCTC
GTGTATCATAGACCGCTTC -> TGTATCATAGACCGCTTCC
GTGTATTGCCACTGTATGT -> TGTATTGCCACTGTATGTC
GTGTCCCTGGTCTTTGCCC -> TGTCCCTGGTCTTTGCCCG
GTGTGGCCCAGTTCAAGGA -> TGTGGCCCAGTTCAAGGAT
GTGTGTGGCCCAGTTCAAG -> TGTGTGGCCCAGTTCAAGG
GTTAATTCTTCCCATCGCC -> TTAATTCTTCCCATCGCCC
GTTACCCCTTTGAATAGCC -> TTACCCCTTTGAATAGCCT
GTTACCCGCCGTGCACGAA -> TTACCCGCCGTGCACGAAG
GTTAGAATAGACCGCCCAG -> TTAGAATAGACCGCCCAGG
GTTAGCAGTTACCCCTTTG -> TTAGCAGTTACCCCTTTGA
GTTAGCCCGCACCCCTGAA -> TTAGCCCGCACCCCTGAAT
GTTAGTAGGGATCCCCGCG -> TTAGTAGGGATCCCCGCGG
GTTATAAGATTCCGAAAAG -> TTATAAGATTCCGAAAAGC
GTTATGTCTCAGCGGTCTA -> TTATGTCTCAGCGGTCTAT
GTTATGTTCTCCGAATAGG -> TTATGTTCTCCGAATAGGG
GTTCAAGGATTTACTTCTA -> TTCAAGGATTTACTTCTAA
GTTCCCGCATGCCGACACC -> TTCCCGCATGCCGACACCA
GTTCGCGCTGCCGTCTTAT -> TTCGCGCTGCCGTCTTATT
GTTCTCCGAATAGGGATGA -> TTCTCCGAATAGGGATGAA
GTTCTGGGTGGAGGCTAAA -> TTCTGGGTGGAGGCTAAAT
GTTCTTTTGAATATCTAGT -> TTCTTTTGAATATCTAGTG
GTTGACCCTTAACCGTCGT -> TTGACCCTTAACCGTCGTA
GTTGCTATTTGGCTACATC -> TTGCTATTTGGCTACATCG
GTTGGGAGGCGCGTTTATG -> TTGGGAGGCGCGTTTATGG
GTTGTATGCATGGAAACAT -> TTGTATGCATGGAAACATC
GTTGTTACCCGCCGTGCAC -> TTGTTACCCGCCGTGCACG
GTTTAACTCACATCAACGT -> TTTAACTCACATCAACGTT
GTTTACGAACCACCGTCTC -> TTTACGAACCACCGTCTCC
GTTTACGGAGGACGGTTCT -> TTTACGGAGGACGGTTCTT
GTTTATAATCATTTATAAT -> TTTATAATCATTTATAATA
GTTTATGGATCTCATTTCC -> TTTATGGATCTCATTTCCA
GTTTCAGTTAGAATAGACC -> TTTCAGTTAGAATAGACCG
GTTTCCCACTACTCACAAG -> TTTCCCACTACTCACAAGA
GTTTGTACCGGGGAGGCTC -> TTTGTACCGGGGAGGCTCG
GTTTGTCTATCATTTGTCA -> TTTGTCTATCATTTGTCAG
GTTTTCATTCGTTAGCCCG -> TTTTCATTCGTTAGCCCGC
TAAAACGAGGTGTATCATA -> AAAACGAGGTGTATCATAG
TAAACATATGAGGAGGGGC -> AAACATATGAGGAGGGGCC
TAAACCTGTCTCCAAACTC -> AAACCTGTCTCCAAACTCC
TAAAGCGATGTGTACTCTT -> AAAGCGATGTGTACTCTTC
TAAAGTACACAAGTATGTC -> AAAGTACACAAGTATGTCG
TAAATAGCAACCCCCCTTC -> AAATAGCAACCCCCCTTCA
TAACAAAGACTAGCAACAC -> AACAAAGACTAGCAACACT
TAACAAATAACAGCGTGGC -> AACAAATAACAGCGTGGCC
TAACAGCGTGGCCTGCCTC -> AACAGCGTGGCCTGCCTCT
TAACCAATGAGGCAGAGGA -> AACCAATGAGGCAGAGGAC
TAACCCGGGATTAGCTTCT -> AACCCGGGATTAGCTTCTC
TAACCGTCGTACGAGCGCC -> AACCGTCGTACGAGCGCCC
TAACCTACATGCTATAGGA -> AACCTACATGCTATAGGAT
TAACGGTACTGGGTGCAAT -> AACGGTACTGGGTGCAATC
TAACGTCTATTCATAACGG -> AACGTCTATTCATAACGGT
TAACTCACATCAACGTTGA -> AACTCACATCAACGTTGAC
TAACTCCGCCCATCCTGAT -> AACTCCGCCCATCCTGATC
TAAGATTCCGAAAAGCCGG -> AAGATTCCGAAAAGCCGGC
TAAGCCTTCTCACAAGGCT -> AAGCCTTCTCACAAGGCTG
TAAGCGTGCGAACGCCGAA -> AAGCGTGCGAACGCCGAAG
TAAGCTAACCTACATGCTA -> AAGCTAACCTACATGCTAT
TAAGCTATCCGACAGTAGG -> AAGCTATCCGACAGTAGGG
TAAGGAATAATATCGATTC -> AAGGAATAATATCGATTCC
TAAGTCTAATTAGATTTCT -> AAGTCTAATTAGATTTCTT
TAATAAAGCGATGTGTACT -> AATAAAGCGATGTGTACTC
TAATATCGATTCCCACCCC -> AATATCGATTCCCACCCCG
TAATATGATCACCGAGCTT -> AATATGATCACCGAGCTTT
TAATCATTTATAATATGAT -> AATCATTTATAATATGATC
TAATTAGATTTCTTACCCA -> AATTAGATTTCTTACCCAG
TAATTCTTCCCATCGCCCG -> AATTCTTCCCATCGCCCGT
TACACAAGTATGTCGACAG -> ACACAAGTATGTCGACAGC
TACACAGCCTCGTAGTAGG -> ACACAGCCTCGTAGTAGGG
TACACCAAAGATCAGCCGC -> ACACCAAAGATCAGCCGCG
TACAGATTTTGCAAACATG -> ACAGATTTTGCAAACATGG
TACAGCTCAACGCAAACCA -> ACAGCTCAACGCAAACCAT
TACATCGATAACCAATGAG -> ACATCGATAACCAATGAGG
TACATGCTATAGGATACCT -> ACATGCTATAGGATACCTT
TACATTTTACCTCCGGGGA -> ACATTTTACCTCCGGGGAT
TACCACCGCCGTCACCGCC -> ACCACCGCCGTCACCGCCT
TACCATGCCTTCGTTTCAG -> ACCATGCCTTCGTTTCAGT
TACCCAGGACGATCGTCTT -> ACCCAGGACGATCGTCTTA
TACCCCGTTATAAGATTCC -> ACCCCGTTATAAGATTCCG
TACCCCTCTGTTATGTCTC -> ACCCCTCTGTTATGTCTCA
TACCCCTTTGAATAGCCTC -> ACCCCTTTGAATAGCCTCC
TACCCGCCGTGCACGAAGG -> ACCCGCCGTGCACGAAGGG
TACCGCTTGTGACCCCGCA -> ACCGCTTGTGACCCCGCAG
TACCGGGGAGGCTCGGGGC -> ACCGGGGAGGCTCGGGGCC
TACCTCCGGGGATTTCAAT -> ACCTCCGGGGATTTCAATT
TACCTTGGTATACCCCGTT -> ACCTTGGTATACCCCGTTA
TACGAACCACCGTCTCCCT -> ACGAACCACCGTCTCCCTA
TACGACGGACCATAAGGAA -> ACGACGGACCATAAGGAAT
TACGAGCGCCCTAGGAATA -> ACGAGCGCCCTAGGAATAT
TACGGAGGACGGTTCTTTT -> ACGGAGGACGGTTCTTTTG
TACGGCTGAGTGGGGGGAG -> ACGGCTGAGTGGGGGGAGT
TACGGGTTCTGGGTGGAGG -> ACGGGTTCTGGGTGGAGGC
TACGTCAACTACATTTTAC -> ACGTCAACTACATTTTACC
TACGTGCACTGATGCACTT -> ACGTGCACTGATGCACTTT
TACGTGGTGCCTATATTCG -> ACGTGGTGCCTATATTCGT
TACTATCGAACAGGGAGTC -> ACTATCGAACAGGGAGTCG
TACTCACAAGATTACACCA -> ACTCACAAGATTACACCAA
TACTCTTCGGACGATACCA -> ACTCTTCGGACGATACCAT
TACTGGGTGCAATCCAGGC -> ACTGGGTGCAATCCAGGCC
TACTGGTTCGCGCTGCCGT -> ACTGGTTCGCGCTGCCGTC
TACTTCATGGGTGGTTGCT -> ACTTCATGGGTGGTTGCTA
TACTTCTAAGCTAACCTAC -> ACTTCTAAGCTAACCTACA
TAGAATAGACCGCCCAGGC -> AGAATAGACCGCCCAGGCC
TAGAATTGCGGTATGAGTT -> AGAATTGCGGTATGAGTTA
TAGACCGCCCAGGCCGCGG -> AGACCGCCCAGGCCGCGGC
TAGACCGCTTCCTTGGGCT -> AGACCGCTTCCTTGGGCTG
TAGACGACGCTCAAGTAGG -> AGACGACGCTCAAGTAGGG
TAGAGACAATGTATGAGTG -> AGAGACAATGTATGAGTGC
TAGATTTCTTACCCAGGAC -> AGATTTCTTACCCAGGACG
TAGCAACACTTACTGGTTC -> AGCAACACTTACTGGTTCG
TAGCAACCCCCCTTCAGAC -> AGCAACCCCCCTTCAGACT
TAGCAGTTACCCCTTTGAA -> AGCAGTTACCCCTTTGAAT
TAGCCCGCACCCCTGAATC -> AGCCCGCACCCCTGAATCC
TAGCCGAAACAGCGCTCCA -> AGCCGAAACAGCGCTCCAC
TAGCCTCCTGGTCGTAAAC -> AGCCTCCTGGTCGTAAACC
TAGCGCCTGATGCCTTCGA -> AGCGCCTGATGCCTTCGAG
TAGCTAAGCCTTCTCACAA -> AGCTAAGCCTTCTCACAAG
TAGCTTCTCCGTTTTCATT -> AGCTTCTCCGTTTTCATTC
TAGGAATATCAGCGCTCTG -> AGGAATATCAGCGCTCTGT
TAGGAGCGTCACTGCAGAG -> AGGAGCGTCACTGCAGAGT
TAGGATACCTTGGTATACC -> AGGATACCTTGGTATACCC
TAGGCATGCAGGATGAAAT -> AGGCATGCAGGATGAAATT
TAGGGATCCCCGCGGGTAT -> AGGGATCCCCGCGGGTATG
TAGGGATCCCCGCGGGTCT -> AGGGATCCCCGCGGGTCTG
TAGGGATCCCCGCGGGTTC -> AGGGATCCCCGCGGGTTCC
TAGGGATCCCCGCGGGTTT -> AGGGATCCCCGCGGGTTTA
TAGGGATGAAAGCATTTGA -> AGGGATGAAAGCATTTGAC
TAGGTGCCTCAGCAACCGA -> AGGTGCCTCAGCAACCGAA
TAGTACGACGGACCATAAG -> AGTACGACGGACCATAAGG
TAGTAGGGATCCCCGCGGG -> AGTAGGGATCCCCGCGGGT,AGTAGGGATCCCCGCGGGT
TAGTGCGCTCAACGCAAAC -> AGTGCGCTCAACGCAAACC
TAGTGTCCCTGGTCTTTGC -> AGTGTCCCTGGTCTTTGCC
TATAAGATTCCGAAAAGCC -> ATAAGATTCCGAAAAGCCG
TATAATATGATCACCGAGC -> ATAATATGATCACCGAGCT
TATAATCATTTATAATATG -> ATAATCATTTATAATATGA
TATACCCCGTTATAAGATT -> ATACCCCGTTATAAGATTC
TATAGGATACCTTGGTATA -> ATAGGATACCTTGGTATAC
TATATTCGTATCGAACACA -> ATATTCGTATCGAACACAA
TATCAGCGCTCTGTCAGTA -> ATCAGCGCTCTGTCAGTAT
TATCATAGACCGCTTCCTT -> ATCATAGACCGCTTCCTTG
TATCATTTGTCAGTACGGG -> ATCATTTGTCAGTACGGGT
TATCCCAGTGGCACTGACT -> ATCCCAGTGGCACTGACTC
TATCCCGCAATGGCCGCTT -> ATCCCGCAATGGCCGCTTA
TATCCGACAGTAGGGATCC -> ATCCGACAGTAGGGATCCC
TATCCTCGGAAACTAGTAC -> ATCCTCGGAAACTAGTACG
TATCGAACACAATCTTTTC -> ATCGAACACAATCTTTTCC
TATCGAACAGGGAGTCGGT -> ATCGAACAGGGAGTCGGTT
TATCGATTCCCACCCCGTC -> ATCGATTCCCACCCCGTCT
TATCGGTGCTGTTAGTAGG -> ATCGGTGCTGTTAGTAGGG
TATCTAGTGTCCCTGGTCT -> ATCTAGTGTCCCTGGTCTT
TATGAGGAGGGGCCCATTG -> ATGAGGAGGGGCCCATTGA
TATGAGTGCATATTGCAAG -> ATGAGTGCATATTGCAAGT
TATGAGTTATGTTCTCCGA -> ATGAGTTATGTTCTCCGAA
TATGATCACCGAGCTTTCA -> ATGATCACCGAGCTTTCAC
TATGCATGGAAACATCATG -> ATGCATGGAAACATCATGG
TATGCCTTGGGGAATCGGC -> ATGCCTTGGGGAATCGGCT
TATGCGAAGCTCGCTACTA -> ATGCGAAGCTCGCTACTAT
TATGGATCTCATTTCCATA -> ATGGATCTCATTTCCATAA
TATGGCCCTCCCGTGACTT -> ATGGCCCTCCCGTGACTTC
TATGGGACCATGCTCGAGG -> ATGGGACCATGCTCGAGGT
TATGTCATTCGATGTGTAG -> ATGTCATTCGATGTGTAGC
TATGTCGACAGCCTAGGCA -> ATGTCGACAGCCTAGGCAT
TATGTCTCAGCGGTCTATG -> ATGTCTCAGCGGTCTATGT
TATGTGCATTACCGCTTGT -> ATGTGCATTACCGCTTGTG
TATGTTCTCCGAATAGGGA -> ATGTTCTCCGAATAGGGAT
TATGTTGTTACCCGCCGTG -> ATGTTGTTACCCGCCGTGC
TATGTTTAACTCACATCAA -> ATGTTTAACTCACATCAAC
TATTCATAACGGTACTGGG -> ATTCATAACGGTACTGGGT
TATTCGTATCGAACACAAT -> ATTCGTATCGAACACAATC
TATTGATATGGCCCTCCCG -> ATTGATATGGCCCTCCCGT
TATTGCAAGTGTGTGGCCC -> ATTGCAAGTGTGTGGCCCA
TATTGCCACTGTATGTCAT -> ATTGCCACTGTATGTCATT
TATTTGGCTACATCGATAA -> ATTTGGCTACATCGATAAC
TCAACGCAAACCATTAAGC -> CAACGCAAACCATTAAGCT
TCAACGCAAACCATTACAC -> CAACGCAAACCATTACACA
TCAACGCAAACCATTAGAC -> CAACGCAAACCATTAGACG
TCAACGCAAACCATTATCG -> CAACGCAAACCATTATCGG
TCAACGTTGACCCTTAACC -> CAACGTTGACCCTTAACCG
TCAACTACATTTTACCTCC -> CAACTACATTTTACCTCCG
TCAAGCGCGAATGCAAGTC -> CAAGCGCGAATGCAAGTCT
TCAAGGATTTACTTCTAAG -> CAAGGATTTACTTCTAAGC
TCAAGGGGCGCCCCACACG -> CAAGGGGCGCCCCACACGG
TCAAGTAGGGATCCCCGCG -> CAAGTAGGGATCCCCGCGG
TCAATTAGCTAAGCCTTCT -> CAATTAGCTAAGCCTTCTC
TCACAAGATTACACCAAAG -> CACAAGATTACACCAAAGA
TCACAAGGCTGATTCAGCA -> CACAAGGCTGATTCAGCAC
TCACATCAACGTTGACCCT -> CACATCAACGTTGACCCTT
TCACCCGCGTAGGAGCGTC -> CACCCGCGTAGGAGCGTCA
TCACCGAGCTTTCACGGAG -> CACCGAGCTTTCACGGAGA
TCACCGCCTCCTTTGTCTG -> CACCGCCTCCTTTGTCTGA
TCACGGAGATGCCAGACAC -> CACGGAGATGCCAGACACG
TCACTGCAGAGTGATCGTT -> CACTGCAGAGTGATCGTTA
TCACTTCCCACGGTAACAA -> CACTTCCCACGGTAACAAA
TCAGACTAAACATATGAGG -> CAGACTAAACATATGAGGA
TCAGCAACCGAACGTTGGG -> CAGCAACCGAACGTTGGGA
TCAGCACTTGCTCAACGCA -> CAGCACTTGCTCAACGCAA
TCAGCCGCGTACCCCTCTG -> CAGCCGCGTACCCCTCTGT
TCAGCGCTCTGTCAGTATC -> CAGCGCTCTGTCAGTATCC
TCAGCGGTCTATGTGCATT -> CAGCGGTCTATGTGCATTA
TCAGGGACGGTATGCCTTG -> CAGGGACGGTATGCCTTGG
TCAGTACGGGTTCTGGGTG -> CAGTACGGGTTCTGGGTGG
TCAGTATCCCGCAATGGCC -> CAGTATCCCGCAATGGCCG
TCAGTTAGAATAGACCGCC -> CAGTTAGAATAGACCGCCC
TCATAACGGTACTGGGTGC -> CATAACGGTACTGGGTGCA
TCATAGACCGCTTCCTTGG -> CATAGACCGCTTCCTTGGG
TCATGGGTGGTTGCTATTT -> CATGGGTGGTTGCTATTTG
TCATGGTAACCCGGGATTA -> CATGGTAACCCGGGATTAG
TCATTAATAAAGCGATGTG -> CATTAATAAAGCGATGTGT
TCATTCGATGTGTAGCCGA -> CATTCGATGTGTAGCCGAA
TCATTCGTTAGCCCGCACC -> CATTCGTTAGCCCGCACCC
TCATTTATAATATGATCAC -> CATTTATAATATGATCACC
TCATTTCCATAAGTCTAAT -> CATTTCCATAAGTCTAATT
TCATTTGTCAGTACGGGTT -> CATTTGTCAGTACGGGTTC
TCCAAACTCCATTGTACGT -> CCAAACTCCATTGTACGTG
TCCAACGAAGGCTACGTGG -> CCAACGAAGGCTACGTGGT
TCCACCTATCCTCGGAAAC -> CCACCTATCCTCGGAAACT
TCCAGGCCCATGGCATAGC -> CCAGGCCCATGGCATAGCG
TCCATAAGTCTAATTAGAT -> CCATAAGTCTAATTAGATT
TCCATCTGTCACCCGCGTA -> CCATCTGTCACCCGCGTAG
TCCATTGTACGTGCACTGA -> CCATTGTACGTGCACTGAT
TCCCACCCCGTCTCTGGAT -> CCCACCCCGTCTCTGGATG
TCCCACGGTAACAAATAAC -> CCCACGGTAACAAATAACA
TCCCACTACTCACAAGATT -> CCCACTACTCACAAGATTA
TCCCAGTGGCACTGACTCG -> CCCAGTGGCACTGACTCGA
TCCCATCGCCCGTAAAACG -> CCCATCGCCCGTAAAACGA
TCCCCGCGGGTATGTTGTT -> CCCCGCGGGTATGTTGTTA
TCCCCGCGGGTCTGACTGC -> CCCCGCGGGTCTGACTGCA
TCCCCGCGGGTTCCCGCAT -> CCCCGCGGGTTCCCGCATG
TCCCCGCGGGTTTACGGAG -> CCCCGCGGGTTTACGGAGG
TCCCGCAATGGCCGCTTAC -> CCCGCAATGGCCGCTTACC
TCCCGCATGCCGACACCAT -> CCCGCATGCCGACACCATC
TCCCGTGACTTCAGGGACG -> CCCGTGACTTCAGGGACGG
TCCCTAACTCCGCCCATCC -> CCCTAACTCCGCCCATCCT
TCCCTGGTCTTTGCCCGTT -> CCCTGGTCTTTGCCCGTTT
TCCGAAAAGCCGGCCATTT -> CCGAAAAGCCGGCCATTTG
TCCGAATAGGGATGAAAGC -> CCGAATAGGGATGAAAGCA
TCCGACAGTAGGGATCCCC -> CCGACAGTAGGGATCCCCG
TCCGCCCATCCTGATCAAG -> CCGCCCATCCTGATCAAGC
TCCGGGGATTTCAATTAGC -> CCGGGGATTTCAATTAGCT
TCCGTCGCGACAAATAGTG -> CCGTCGCGACAAATAGTGC
TCCGTTTTCATTCGTTAGC -> CCGTTTTCATTCGTTAGCC
TCCTATCCCAGTGGCACTG -> CCTATCCCAGTGGCACTGA
TCCTCGGAAACTAGTACGA -> CCTCGGAAACTAGTACGAC
TCCTGATCAAGCGCGAATG -> CCTGATCAAGCGCGAATGC
TCCTGGTCGTAAACCTGTC -> CCTGGTCGTAAACCTGTCT
TCCTTGGGCTGAAATCCTA -> CCTTGGGCTGAAATCCTAT
TCCTTTCCGTCGCGACAAA -> CCTTTCCGTCGCGACAAAT
TCCTTTGTCTGACTGAATC -> CCTTTGTCTGACTGAATCC
TCGAACACAATCTTTTCCT -> CGAACACAATCTTTTCCTT
TCGAACAGGGAGTCGGTTT -> CGAACAGGGAGTCGGTTTA
TCGACAGCCTAGGCATGCA -> CGACAGCCTAGGCATGCAG
TCGAGGAGGCCCGACGGTG -> CGAGGAGGCCCGACGGTGT
TCGAGGTACAGATTTTGCA -> CGAGGTACAGATTTTGCAA
TCGATAACCAATGAGGCAG -> CGATAACCAATGAGGCAGA
TCGATCTGTATGGGACCAT -> CGATCTGTATGGGACCATG
TCGATGTGTAGCCGAAACA -> CGATGTGTAGCCGAAACAG
TCGATTCCCACCCCGTCTC -> CGATTCCCACCCCGTCTCT
TCGCCCGTAAAACGAGGTG -> CGCCCGTAAAACGAGGTGT
TCGCCGTTGTATGCATGGA -> CGCCGTTGTATGCATGGAA
TCGCGACAAATAGTGCGCT -> CGCGACAAATAGTGCGCTC
TCGCGCTGCCGTCTTATTG -> CGCGCTGCCGTCTTATTGA
TCGCTACTATCGAACAGGG -> CGCTACTATCGAACAGGGA
TCGGAAACTAGTACGACGG -> CGGAAACTAGTACGACGGA
TCGGACGATACCATGCCTT -> CGGACGATACCATGCCTTC
TCGGCTCAACGCAAACCAT -> CGGCTCAACGCAAACCATT
TCGGGGCCAAAGTAGAGAC -> CGGGGCCAAAGTAGAGACA
TCGGTGCTGTTAGTAGGGA -> CGGTGCTGTTAGTAGGGAT
TCGGTTTACGAACCACCGT -> CGGTTTACGAACCACCGTC
TCGTAAACCTGTCTCCAAA -> CGTAAACCTGTCTCCAAAC
TCGTACGAGCGCCCTAGGA -> CGTACGAGCGCCCTAGGAA
TCGTAGAATTGCGGTATGA -> CGTAGAATTGCGGTATGAG
TCGTAGTAGGGATCCCCGC -> CGTAGTAGGGATCCCCGCG
TCGTATCGAACACAATCTT -> CGTATCGAACACAATCTTT
TCGTCTTACGTCAACTACA -> CGTCTTACGTCAACTACAT
TCGTTAATTCTTCCCATCG -> CGTTAATTCTTCCCATCGC
TCGTTAGCCCGCACCCCTG -> CGTTAGCCCGCACCCCTGA
TCGTTTCAGTTAGAATAGA -> CGTTTCAGTTAGAATAGAC
TCTAAGCTAACCTACATGC -> CTAAGCTAACCTACATGCT
TCTAATTAGATTTCTTACC -> CTAATTAGATTTCTTACCC
TCTAGTGTCCCTGGTCTTT -> CTAGTGTCCCTGGTCTTTG
TCTATCATTTGTCAGTACG -> CTATCATTTGTCAGTACGG
TCTATGTGCATTACCGCTT -> CTATGTGCATTACCGCTTG
TCTATTCATAACGGTACTG -> CTATTCATAACGGTACTGG
TCTCACAAGGCTGATTCAG -> CTCACAAGGCTGATTCAGC
TCTCAGCGGTCTATGTGCA -> CTCAGCGGTCTATGTGCAT
TCTCATTTCCATAAGTCTA -> CTCATTTCCATAAGTCTAA
TCTCCAAACTCCATTGTAC -> CTCCAAACTCCATTGTACG
TCTCCCTAACTCCGCCCAT -> CTCCCTAACTCCGCCCATC
TCTCCGAATAGGGATGAAA -> CTCCGAATAGGGATGAAAG
TCTCCGTTTTCATTCGTTA -> CTCCGTTTTCATTCGTTAG
TCTCTGGATGTGCTAACAA -> CTCTGGATGTGCTAACAAA
TCTGACTGAATCCAACGAA -> CTGACTGAATCCAACGAAG
TCTGACTGCACGACGCCTA -> CTGACTGCACGACGCCTAT
TCTGAGTACTTCATGGGTG -> CTGAGTACTTCATGGGTGG
TCTGAGTGAGTTAGCAGTT -> CTGAGTGAGTTAGCAGTTA
TCTGGATGTGCTAACAAAG -> CTGGATGTGCTAACAAAGA
TCTGGCTCACTTCCCACGG -> CTGGCTCACTTCCCACGGT
TCTGGGTGGAGGCTAAATA -> CTGGGTGGAGGCTAAATAG
TCTGTATGGGACCATGCTC -> CTGTATGGGACCATGCTCG
TCTGTCACCCGCGTAGGAG -> CTGTCACCCGCGTAGGAGC
TCTGTCAGTATCCCGCAAT -> CTGTCAGTATCCCGCAATG
TCTGTTATGTCTCAGCGGT -> CTGTTATGTCTCAGCGGTC
TCTTAAGCGTGCGAACGCC -> CTTAAGCGTGCGAACGCCG
TCTTACCCAGGACGATCGT -> CTTACCCAGGACGATCGTC
TCTTACGTCAACTACATTT -> CTTACGTCAACTACATTTT
TCTTATGTTTAACTCACAT -> CTTATGTTTAACTCACATC
TCTTATTGATATGGCCCTC -> CTTATTGATATGGCCCTCC
TCTTCCCATCGCCCGTAAA -> CTTCCCATCGCCCGTAAAA
TCTTCGGACGATACCATGC -> CTTCGGACGATACCATGCC
TCTTCTGAGTGAGTTAGCA -> CTTCTGAGTGAGTTAGCAG
TCTTGTTTCCCACTACTCA -> CTTGTTTCCCACTACTCAC
TCTTTGCCCGTTTGTCTAT -> CTTTGCCCGTTTGTCTATC
TCTTTTCCTTTCCGTCGCG -> CTTTTCCTTTCCGTCGCGA
TCTTTTGAATATCTAGTGT -> CTTTTGAATATCTAGTGTC
TGAAAGCATTTGACTTAAC -> GAAAGCATTTGACTTAACG
TGAAATCCTATCCCAGTGG -> GAAATCCTATCCCAGTGGC
TGAAATTCTTGTTTCCCAC -> GAAATTCTTGTTTCCCACT
TGAACATACGGCTGAGTGG -> GAACATACGGCTGAGTGGG
TGAATAGCCTCCTGGTCGT -> GAATAGCCTCCTGGTCGTA
TGAATATCTAGTGTCCCTG -> GAATATCTAGTGTCCCTGG
TGAATCCAACGAAGGCTAC -> GAATCCAACGAAGGCTACG
TGAATCCATCTGTCACCCG -> GAATCCATCTGTCACCCGC
TGACCCCGCAGTGCGTCAA -> GACCCCGCAGTGCGTCAAG
TGACCCTTAACCGTCGTAC -> GACCCTTAACCGTCGTACG
TGACTCGATCTGTATGGGA -> GACTCGATCTGTATGGGAC
TGACTGAATCCAACGAAGG -> GACTGAATCCAACGAAGGC
TGACTGCACGACGCCTATG -> GACTGCACGACGCCTATGC
TGACTTAACGTCTATTCAT -> GACTTAACGTCTATTCATA
TGACTTCAGGGACGGTATG -> GACTTCAGGGACGGTATGC
TGAGGAGGGGCCCATTGAA -> GAGGAGGGGCCCATTGAAC
TGAGGCAGAGGACCCCAGA -> GAGGCAGAGGACCCCAGAC
TGAGTACTTCATGGGTGGT -> GAGTACTTCATGGGTGGTT
TGAGTGAGTTAGCAGTTAC -> GAGTGAGTTAGCAGTTACC
TGAGTGCATATTGCAAGTG -> GAGTGCATATTGCAAGTGT
TGAGTGGGGGGAGTTTATA -> GAGTGGGGGGAGTTTATAA
TGAGTTAGCAGTTACCCCT -> GAGTTAGCAGTTACCCCTT
TGAGTTATGTTCTCCGAAT -> GAGTTATGTTCTCCGAATA
TGATATGGCCCTCCCGTGA -> GATATGGCCCTCCCGTGAC
TGATCAAGCGCGAATGCAA -> GATCAAGCGCGAATGCAAG
TGATCACCGAGCTTTCACG -> GATCACCGAGCTTTCACGG
TGATCGTTAATTCTTCCCA -> GATCGTTAATTCTTCCCAT
TGATGCACTTTCGCCGTTG -> GATGCACTTTCGCCGTTGT
TGATGCCTTCGAGGAGGCC -> GATGCCTTCGAGGAGGCCC
TGATTCAGCACTTGCTCAA -> GATTCAGCACTTGCTCAAC
TGCAAACATGGAACGCACG -> GCAAACATGGAACGCACGA
TGCAAGTCTGGCTCACTTC -> GCAAGTCTGGCTCACTTCC
TGCAAGTGTGTGGCCCAGT -> GCAAGTGTGTGGCCCAGTT
TGCAATCCAGGCCCATGGC -> GCAATCCAGGCCCATGGCA
TGCACGAAGGGGACCACAA -> GCACGAAGGGGACCACAAG
TGCACGACGCCTATGCGAA -> GCACGACGCCTATGCGAAG
TGCACTGATGCACTTTCGC -> GCACTGATGCACTTTCGCC
TGCACTTTCGCCGTTGTAT -> GCACTTTCGCCGTTGTATG
TGCAGAGTGATCGTTAATT -> GCAGAGTGATCGTTAATTC
TGCAGGATGAAATTCTTGT -> GCAGGATGAAATTCTTGTT
TGCATATTGCAAGTGTGTG -> GCATATTGCAAGTGTGTGG
TGCATGGAAACATCATGGT -> GCATGGAAACATCATGGTA
TGCATTACCGCTTGTGACC -> GCATTACCGCTTGTGACCC
TGCCACTGTATGTCATTCG -> GCCACTGTATGTCATTCGA
TGCCAGACACGTCTTATGT -> GCCAGACACGTCTTATGTT
TGCCCGTTTGTCTATCATT -> GCCCGTTTGTCTATCATTT
TGCCGACACCATCTTCTGA -> GCCGACACCATCTTCTGAG
TGCCGTCTTATTGATATGG -> GCCGTCTTATTGATATGGC
TGCCTATATTCGTATCGAA -> GCCTATATTCGTATCGAAC
TGCCTCAGCAACCGAACGT -> GCCTCAGCAACCGAACGTT
TGCCTCTGAGTACTTCATG -> GCCTCTGAGTACTTCATGG
TGCCTTCGAGGAGGCCCGA -> GCCTTCGAGGAGGCCCGAC
TGCCTTCGTTTCAGTTAGA -> GCCTTCGTTTCAGTTAGAA
TGCCTTGGGGAATCGGCTC -> GCCTTGGGGAATCGGCTCA
TGCGAACGCCGAAGCGCGC -> GCGAACGCCGAAGCGCGCA
TGCGAAGCTCGCTACTATC -> GCGAAGCTCGCTACTATCG
TGCGCTCAACGCAAACCAT -> GCGCTCAACGCAAACCATT
TGCGGTATGAGTTATGTTC -> GCGGTATGAGTTATGTTCT
TGCGTCAAGGGGCGCCCCA -> GCGTCAAGGGGCGCCCCAC
TGCTAACAAAGACTAGCAA -> GCTAACAAAGACTAGCAAC
TGCTATAGGATACCTTGGT -> GCTATAGGATACCTTGGTA
TGCTATTTGGCTACATCGA -> GCTATTTGGCTACATCGAT
TGCTCAACGCAAACCATTA -> GCTCAACGCAAACCATTAT
TGCTCATTAATAAAGCGAT -> GCTCATTAATAAAGCGATG
TGCTCGAGGTACAGATTTT -> GCTCGAGGTACAGATTTTG
TGCTGTTAGTAGGGATCCC -> GCTGTTAGTAGGGATCCCC
TGGAAACATCATGGTAACC -> GGAAACATCATGGTAACCC
TGGAACGCACGACTAGGTG -> GGAACGCACGACTAGGTGC
TGGAGATGCTCATTAATAA -> GGAGATGCTCATTAATAAA
TGGAGGCTAAATAGCAACC -> GGAGGCTAAATAGCAACCC
TGGATCTCATTTCCATAAG -> GGATCTCATTTCCATAAGT
TGGATGTGCTAACAAAGAC -> GGATGTGCTAACAAAGACT
TGGCACTGACTCGATCTGT -> GGCACTGACTCGATCTGTA
TGGCATAGCGCCTGATGCC -> GGCATAGCGCCTGATGCCT
TGGCCCAGTTCAAGGATTT -> GGCCCAGTTCAAGGATTTA
TGGCCCTCCCGTGACTTCA -> GGCCCTCCCGTGACTTCAG
TGGCCGCTTACCACCGCCG -> GGCCGCTTACCACCGCCGT
TGGCCTGCCTCTGAGTACT -> GGCCTGCCTCTGAGTACTT
TGGCTACATCGATAACCAA -> GGCTACATCGATAACCAAT
TGGCTCACTTCCCACGGTA -> GGCTCACTTCCCACGGTAA
TGGGACCATGCTCGAGGTA -> GGGACCATGCTCGAGGTAC
TGGGAGGCGCGTTTATGGA -> GGGAGGCGCGTTTATGGAT
TGGGCTGAAATCCTATCCC -> GGGCTGAAATCCTATCCCA
TGGGGAATCGGCTCAACGC -> GGGGAATCGGCTCAACGCA
TGGGGGGAGTTTATAATCA -> GGGGGGAGTTTATAATCAT
TGGGTGCAATCCAGGCCCA -> GGGTGCAATCCAGGCCCAT
TGGGTGGAGGCTAAATAGC -> GGGTGGAGGCTAAATAGCA
TGGGTGGTTGCTATTTGGC -> GGGTGGTTGCTATTTGGCT
TGGTAAAGTACACAAGTAT -> GGTAAAGTACACAAGTATG
TGGTAACCCGGGATTAGCT -> GGTAACCCGGGATTAGCTT
TGGTATACCCCGTTATAAG -> GGTATACCCCGTTATAAGA
TGGTCGTAAACCTGTCTCC -> GGTCGTAAACCTGTCTCCA
TGGTCTTTGCCCGTTTGTC -> GGTCTTTGCCCGTTTGTCT
TGGTGCCTATATTCGTATC -> GGTGCCTATATTCGTATCG
TGGTTCGCGCTGCCGTCTT -> GGTTCGCGCTGCCGTCTTA
TGGTTGCTATTTGGCTACA -> GGTTGCTATTTGGCTACAT
TGTACAGCTCAACGCAAAC -> GTACAGCTCAACGCAAACC
TGTACCGGGGAGGCTCGGG -> GTACCGGGGAGGCTCGGGG
TGTACGTGCACTGATGCAC -> GTACGTGCACTGATGCACT
TGTACTCTTCGGACGATAC -> GTACTCTTCGGACGATACC
TGTAGCCGAAACAGCGCTC -> GTAGCCGAAACAGCGCTCC
TGTATCATAGACCGCTTCC -> GTATCATAGACCGCTTCCT
TGTATGAGTGCATATTGCA -> GTATGAGTGCATATTGCAA
TGTATGCATGGAAACATCA -> GTATGCATGGAAACATCAT
TGTATGGGACCATGCTCGA -> GTATGGGACCATGCTCGAG
TGTATGTCATTCGATGTGT -> GTATGTCATTCGATGTGTA
TGTATTGCCACTGTATGTC -> GTATTGCCACTGTATGTCA
TGTCACCCGCGTAGGAGCG -> GTCACCCGCGTAGGAGCGT
TGTCAGTACGGGTTCTGGG -> GTCAGTACGGGTTCTGGGT
TGTCAGTATCCCGCAATGG -> GTCAGTATCCCGCAATGGC
TGTCATTCGATGTGTAGCC -> GTCATTCGATGTGTAGCCG
TGTCCCTGGTCTTTGCCCG -> GTCCCTGGTCTTTGCCCGT
TGTCGACAGCCTAGGCATG -> GTCGACAGCCTAGGCATGC
TGTCTATCATTTGTCAGTA -> GTCTATCATTTGTCAGTAC
TGTCTCAGCGGTCTATGTG -> GTCTCAGCGGTCTATGTGC
TGTCTCCAAACTCCATTGT -> GTCTCCAAACTCCATTGTA
TGTCTGACTGAATCCAACG -> GTCTGACTGAATCCAACGA
TGTGACCCCGCAGTGCGTC -> GTGACCCCGCAGTGCGTCA
TGTGCATTACCGCTTGTGA -> GTGCATTACCGCTTGTGAC
TGTGCTAACAAAGACTAGC -> GTGCTAACAAAGACTAGCA
TGTGGCCCAGTTCAAGGAT -> GTGGCCCAGTTCAAGGATT
TGTGTACTCTTCGGACGAT -> GTGTACTCTTCGGACGATA
TGTGTAGCCGAAACAGCGC -> GTGTAGCCGAAACAGCGCT
TGTGTGGCCCAGTTCAAGG -> GTGTGGCCCAGTTCAAGGA
TGTTACCCGCCGTGCACGA -> GTTACCCGCCGTGCACGAA
TGTTAGTAGGGATCCCCGC -> GTTAGTAGGGATCCCCGCG
TGTTATGTCTCAGCGGTCT -> GTTATGTCTCAGCGGTCTA
TGTTCTCCGAATAGGGATG -> GTTCTCCGAATAGGGATGA
TGTTGTTACCCGCCGTGCA -> GTTGTTACCCGCCGTGCAC
TGTTTAACTCACATCAACG -> GTTTAACTCACATCAACGT
TGTTTCCCACTACTCACAA -> GTTTCCCACTACTCACAAG
TTAACCGTCGTACGAGCGC -> TAACCGTCGTACGAGCGCC
TTAACGTCTATTCATAACG -> TAACGTCTATTCATAACGG
TTAACTCACATCAACGTTG -> TAACTCACATCAACGTTGA
TTAAGCGTGCGAACGCCGA -> TAAGCGTGCGAACGCCGAA
TTAAGCTATCCGACAGTAG -> TAAGCTATCCGACAGTAGG
TTAATAAAGCGATGTGTAC -> TAATAAAGCGATGTGTACT
TTAATTCTTCCCATCGCCC -> TAATTCTTCCCATCGCCCG
TTACACAGCCTCGTAGTAG -> TACACAGCCTCGTAGTAGG
TTACACCAAAGATCAGCCG -> TACACCAAAGATCAGCCGC
TTACCACCGCCGTCACCGC -> TACCACCGCCGTCACCGCC
TTACCCAGGACGATCGTCT -> TACCCAGGACGATCGTCTT
TTACCCCTTTGAATAGCCT -> TACCCCTTTGAATAGCCTC
TTACCCGCCGTGCACGAAG -> TACCCGCCGTGCACGAAGG
TTACCGCTTGTGACCCCGC -> TACCGCTTGTGACCCCGCA
TTACCTCCGGGGATTTCAA -> TACCTCCGGGGATTTCAAT
TTACGAACCACCGTCTCCC -> TACGAACCACCGTCTCCCT
TTACGGAGGACGGTTCTTT -> TACGGAGGACGGTTCTTTT
TTACGTCAACTACATTTTA -> TACGTCAACTACATTTTAC
TTACTGGTTCGCGCTGCCG -> TACTGGTTCGCGCTGCCGT
TTACTTCTAAGCTAACCTA -> TACTTCTAAGCTAACCTAC
TTAGAATAGACCGCCCAGG -> TAGAATAGACCGCCCAGGC
TTAGACGACGCTCAAGTAG -> TAGACGACGCTCAAGTAGG
TTAGATTTCTTACCCAGGA -> TAGATTTCTTACCCAGGAC
TTAGCAGTTACCCCTTTGA -> TAGCAGTTACCCCTTTGAA
TTAGCCCGCACCCCTGAAT -> TAGCCCGCACCCCTGAATC
TTAGCTAAGCCTTCTCACA -> TAGCTAAGCCTTCTCACAA
TTAGCTTCTCCGTTTTCAT -> TAGCTTCTCCGTTTTCATT
TTAGTAGGGATCCCCGCGG -> TAGTAGGGATCCCCGCGGG
TTATAAGATTCCGAAAAGC -> TATAAGATTCCGAAAAGCC
TTATAATATGATCACCGAG -> TATAATATGATCACCGAGC
TTATAATCATTTATAATAT -> TATAATCATTTATAATATG
TTATCGGTGCTGTTAGTAG -> TATCGGTGCTGTTAGTAGG
TTATGGATCTCATTTCCAT -> TATGGATCTCATTTCCATA
TTATGTCTCAGCGGTCTAT -> TATGTCTCAGCGGTCTATG
TTATGTTCTCCGAATAGGG -> TATGTTCTCCGAATAGGGA
TTATGTTTAACTCACATCA -> TATGTTTAACTCACATCAA
TTATTGATATGGCCCTCCC -> TATTGATATGGCCCTCCCG
TTCAAGGATTTACTTCTAA -> TCAAGGATTTACTTCTAAG
TTCAATTAGCTAAGCCTTC -> TCAATTAGCTAAGCCTTCT
TTCACGGAGATGCCAGACA -> TCACGGAGATGCCAGACAC
TTCAGACTAAACATATGAG -> TCAGACTAAACATATGAGG
TTCAGCACTTGCTCAACGC -> TCAGCACTTGCTCAACGCA
TTCAGGGACGGTATGCCTT -> TCAGGGACGGTATGCCTTG
TTCAGTTAGAATAGACCGC -> TCAGTTAGAATAGACCGCC
TTCATAACGGTACTGGGTG -> TCATAACGGTACTGGGTGC
TTCATGGGTGGTTGCTATT -> TCATGGGTGGTTGCTATTT
TTCATTCGTTAGCCCGCAC -> TCATTCGTTAGCCCGCACC
TTCCATAAGTCTAATTAGA -> TCCATAAGTCTAATTAGAT
TTCCCACCCCGTCTCTGGA -> TCCCACCCCGTCTCTGGAT
TTCCCACGGTAACAAATAA -> TCCCACGGTAACAAATAAC
TTCCCACTACTCACAAGAT -> TCCCACTACTCACAAGATT
TTCCCATCGCCCGTAAAAC -> TCCCATCGCCCGTAAAACG
TTCCCGCATGCCGACACCA -> TCCCGCATGCCGACACCAT
TTCCGAAAAGCCGGCCATT -> TCCGAAAAGCCGGCCATTT
TTCCGTCGCGACAAATAGT -> TCCGTCGCGACAAATAGTG
TTCCTTGGGCTGAAATCCT -> TCCTTGGGCTGAAATCCTA
TTCCTTTCCGTCGCGACAA -> TCCTTTCCGTCGCGACAAA
TTCGAGGAGGCCCGACGGT -> TCGAGGAGGCCCGACGGTG
TTCGATGTGTAGCCGAAAC -> TCGATGTGTAGCCGAAACA
TTCGCCGTTGTATGCATGG -> TCGCCGTTGTATGCATGGA
TTCGCGCTGCCGTCTTATT -> TCGCGCTGCCGTCTTATTG
TTCGGACGATACCATGCCT -> TCGGACGATACCATGCCTT
TTCGTAGAATTGCGGTATG -> TCGTAGAATTGCGGTATGA
TTCGTATCGAACACAATCT -> TCGTATCGAACACAATCTT
TTCGTTAGCCCGCACCCCT -> TCGTTAGCCCGCACCCCTG
TTCGTTTCAGTTAGAATAG -> TCGTTTCAGTTAGAATAGA
TTCTAAGCTAACCTACATG -> TCTAAGCTAACCTACATGC
TTCTCACAAGGCTGATTCA -> TCTCACAAGGCTGATTCAG
TTCTCCGAATAGGGATGAA -> TCTCCGAATAGGGATGAAA
TTCTCCGTTTTCATTCGTT -> TCTCCGTTTTCATTCGTTA
TTCTGAGTGAGTTAGCAGT -> TCTGAGTGAGTTAGCAGTT
TTCTGGGTGGAGGCTAAAT -> TCTGGGTGGAGGCTAAATA
TTCTTACCCAGGACGATCG -> TCTTACCCAGGACGATCGT
TTCTTCCCATCGCCCGTAA -> TCTTCCCATCGCCCGTAAA
TTCTTGTTTCCCACTACTC -> TCTTGTTTCCCACTACTCA
TTCTTTTGAATATCTAGTG -> TCTTTTGAATATCTAGTGT
TTGAACATACGGCTGAGTG -> TGAACATACGGCTGAGTGG
TTGAATAGCCTCCTGGTCG -> TGAATAGCCTCCTGGTCGT
TTGAATATCTAGTGTCCCT -> TGAATATCTAGTGTCCCTG
TTGACCCTTAACCGTCGTA -> TGACCCTTAACCGTCGTAC
TTGACTTAACGTCTATTCA -> TGACTTAACGTCTATTCAT
TTGATATGGCCCTCCCGTG -> TGATATGGCCCTCCCGTGA
TTGCAAACATGGAACGCAC -> TGCAAACATGGAACGCACG
TTGCAAGTGTGTGGCCCAG -> TGCAAGTGTGTGGCCCAGT
TTGCCACTGTATGTCATTC -> TGCCACTGTATGTCATTCG
TTGCCCGTTTGTCTATCAT -> TGCCCGTTTGTCTATCATT
TTGCGGTATGAGTTATGTT -> TGCGGTATGAGTTATGTTC
TTGCTATTTGGCTACATCG -> TGCTATTTGGCTACATCGA
TTGCTCAACGCAAACCATT -> TGCTCAACGCAAACCATTA
TTGGAGATGCTCATTAATA -> TGGAGATGCTCATTAATAA
TTGGCTACATCGATAACCA -> TGGCTACATCGATAACCAA
TTGGGAGGCGCGTTTATGG -> TGGGAGGCGCGTTTATGGA
TTGGGCTGAAATCCTATCC -> TGGGCTGAAATCCTATCCC
TTGGGGAATCGGCTCAACG -> TGGGGAATCGGCTCAACGC
TTGGTATACCCCGTTATAA -> TGGTATACCCCGTTATAAG
TTGTACCGGGGAGGCTCGG -> TGTACCGGGGAGGCTCGGG
TTGTACGTGCACTGATGCA -> TGTACGTGCACTGATGCAC
TTGTATGCATGGAAACATC -> TGTATGCATGGAAACATCA
TTGTCAGTACGGGTTCTGG -> TGTCAGTACGGGTTCTGGG
TTGTCTATCATTTGTCAGT -> TGTCTATCATTTGTCAGTA
TTGTCTGACTGAATCCAAC -> TGTCTGACTGAATCCAACG
TTGTGACCCCGCAGTGCGT -> TGTGACCCCGCAGTGCGTC
TTGTTACCCGCCGTGCACG -> TGTTACCCGCCGTGCACGA
TTGTTTCCCACTACTCACA -> TGTTTCCCACTACTCACAA
TTTAACTCACATCAACGTT -> TTAACTCACATCAACGTTG
TTTACCTCCGGGGATTTCA -> TTACCTCCGGGGATTTCAA
TTTACGAACCACCGTCTCC -> TTACGAACCACCGTCTCCC
TTTACGGAGGACGGTTCTT -> TTACGGAGGACGGTTCTTT
TTTACTTCTAAGCTAACCT -> TTACTTCTAAGCTAACCTA
TTTATAATATGATCACCGA -> TTATAATATGATCACCGAG
TTTATAATCATTTATAATA -> TTATAATCATTTATAATAT
TTTATGGATCTCATTTCCA -> TTATGGATCTCATTTCCAT
TTTCAATTAGCTAAGCCTT -> TTCAATTAGCTAAGCCTTC
TTTCACGGAGATGCCAGAC -> TTCACGGAGATGCCAGACA
TTTCAGTTAGAATAGACCG -> TTCAGTTAGAATAGACCGC
TTTCATTCGTTAGCCCGCA -> TTCATTCGTTAGCCCGCAC
TTTCCATAAGTCTAATTAG -> TTCCATAAGTCTAATTAGA
TTTCCCACTACTCACAAGA -> TTCCCACTACTCACAAGAT
TTTCCGTCGCGACAAATAG -> TTCCGTCGCGACAAATAGT
TTTCCTTTCCGTCGCGACA -> TTCCTTTCCGTCGCGACAA
TTTCGCCGTTGTATGCATG -> TTCGCCGTTGTATGCATGG
TTTCTTACCCAGGACGATC -> TTCTTACCCAGGACGATCG
TTTGAATAGCCTCCTGGTC -> TTGAATAGCCTCCTGGTCG
TTTGAATATCTAGTGTCCC -> TTGAATATCTAGTGTCCCT
TTTGACTTAACGTCTATTC -> TTGACTTAACGTCTATTCA
TTTGCAAACATGGAACGCA -> TTGCAAACATGGAACGCAC
TTTGCCCGTTTGTCTATCA -> TTGCCCGTTTGTCTATCAT
TTTGGAGATGCTCATTAAT -> TTGGAGATGCTCATTAATA
TTTGGCTACATCGATAACC -> TTGGCTACATCGATAACCA
TTTGTACCGGGGAGGCTCG -> TTGTACCGGGGAGGCTCGG
TTTGTCAGTACGGGTTCTG -> TTGTCAGTACGGGTTCTGG
TTTGTCTATCATTTGTCAG -> TTGTCTATCATTTGTCAGT
TTTGTCTGACTGAATCCAA -> TTGTCTGACTGAATCCAAC
TTTTACCTCCGGGGATTTC -> TTTACCTCCGGGGATTTCA
TTTTCATTCGTTAGCCCGC -> TTTCATTCGTTAGCCCGCA
TTTTCCTTTCCGTCGCGAC -> TTTCCTTTCCGTCGCGACA
TTTTGAATATCTAGTGTCC -> TTTGAATATCTAGTGTCCC
TTTTGCAAACATGGAACGC -> TTTGCAAACATGGAACGCA
